Season,Year,Host_City,Host_Country,Country,Country_Code,Gold,Silver,Bronze,Total_Medal,Men,Women,Total_Participation,Population,Latitude,Longtitude
summer,1960,Rome,Italy,Argentina,ARG,2,3,1,6,5,4,9,45267449,-38.416097,-63.616672
summer,1960,Rome,Italy,Australia,AUS,3,6,1,10,10,1,11,25550683,-25.274398,133.775136
summer,1960,Rome,Italy,Austria,AUT,11,8,11,30,12,7,19,9015361,47.516231,14.550072
summer,1960,Rome,Italy,Belgium,BEL,1,1,1,3,10,2,12,11598451,50.503887,4.469936
summer,1960,Rome,Italy,Finland,FIN,1,0,0,1,1,0,1,5542237,61.92411,25.748151
summer,1960,Rome,Italy,France,FRA,3,3,1,7,10,1,11,65298930,46.227638,2.213749
summer,1960,Rome,Italy,Germany,GER,15,6,9,30,7,2,9,83830972,51.165691,10.451526
summer,1960,Rome,Italy,Great Britain,GBR,20,15,20,55,29,13,42,67948282,55.378051,-3.435973
summer,1960,Rome,Italy,Ireland,IRL,2,0,0,2,0,1,1,4947267,53.41291,-8.24389
summer,1960,Rome,Italy,Israel,ISR,0,2,2,4,6,1,7,8678517,31.046051,34.851612
summer,1960,Rome,Italy,Italy,ITA,29,28,23,80,23,4,27,60446035,41.87194,12.56738
summer,1960,Rome,Italy,Malta,MLT,0,2,2,4,5,1,6,441750,35.937496,14.375416
summer,1960,Rome,Italy,Netherlands,NED,3,6,0,9,11,2,13,17141544,52.132633,5.291266
summer,1960,Rome,Italy,Norway,NOR,9,3,4,16,7,4,11,5428594,60.472024,8.468946
summer,1960,Rome,Italy,Rhodesia,ZIM,2,1,2,5,0,1,1,7980000,-19.016666,30.016666
summer,1960,Rome,Italy,Switzerland,SUI,1,3,0,4,5,1,6,8665615,46.818188,8.227512
summer,1960,Rome,Italy,United States of America ,USA,11,7,7,25,23,0,23,#N/A,#N/A,#N/A
summer,1964,Tokyo,Japan,Argentina,ARG,6,15,16,37,19,6,25,45267449,-38.416097,-63.616672
summer,1964,Tokyo,Japan,Australia,AUS,12,11,7,30,13,4,17,25550683,-25.274398,133.775136
summer,1964,Tokyo,Japan,Austria,AUT,4,1,7,12,3,4,7,9015361,47.516231,14.550072
summer,1964,Tokyo,Japan,Belgium,BEL,1,0,2,3,1,1,2,11598451,50.503887,4.469936
summer,1964,Tokyo,Japan,Fiji,FIJ,0,0,0,0,1,0,1,897573,-16.578193,179.414413
summer,1964,Tokyo,Japan,France,FRA,4,2,5,11,13,0,13,65298930,46.227638,2.213749
summer,1964,Tokyo,Japan,Germany,GER,5,2,5,12,8,1,9,83830972,51.165691,10.451526
summer,1964,Tokyo,Japan,Great Britain,GBR,18,23,20,61,30,14,44,67948282,55.378051,-3.435973
summer,1964,Tokyo,Japan,Ireland,IRL,0,0,0,0,2,0,2,4947267,53.41291,-8.24389
summer,1964,Tokyo,Japan,Israel,ISR,7,3,11,21,16,3,19,8678517,31.046051,34.851612
summer,1964,Tokyo,Japan,Italy,ITA,14,15,16,45,14,5,19,60446035,41.87194,12.56738
summer,1964,Tokyo,Japan,Japan,JPN,1,5,4,10,14,2,16,126407422,36.204824,138.252924
summer,1964,Tokyo,Japan,Malta,MLT,0,0,2,2,2,0,2,441750,35.937496,14.375416
summer,1964,Tokyo,Japan,Netherlands,NED,4,6,4,14,4,3,7,17141544,52.132633,5.291266
summer,1964,Tokyo,Japan,Rhodesia,ZIM,10,5,2,17,4,2,6,7980000,-19.016666,30.016666
summer,1964,Tokyo,Japan,South Africa,RSA,8,8,3,19,5,4,9,59436725,-30.559482,22.937506
summer,1964,Tokyo,Japan,Sweden,SWE,0,0,1,1,1,0,1,10110233,60.128161,18.643501
summer,1964,Tokyo,Japan,Switzerland,SUI,0,1,0,1,0,1,1,8665615,46.818188,8.227512
summer,1964,Tokyo,Japan,United States of America ,USA,50,41,32,123,45,20,65,#N/A,#N/A,#N/A
summer,1964,Tokyo,Japan,Germany,FRG,0,0,0,0,0,1,1,83830972,51.165691,10.451526
summer,1968,Tel Aviv,Israel,Argentina,ARG,10,10,10,30,14,7,21,45267449,-38.416097,-63.616672
summer,1968,Tel Aviv,Israel,Australia,AUS,15,16,7,38,23,12,35,25550683,-25.274398,133.775136
summer,1968,Tel Aviv,Israel,Austria,AUT,2,7,10,19,19,12,31,9015361,47.516231,14.550072
summer,1968,Tel Aviv,Israel,Belgium,BEL,0,3,3,6,21,5,26,11598451,50.503887,4.469936
summer,1968,Tel Aviv,Israel,Canada,CAN,6,6,7,19,18,7,25,37799407,56.130366,-106.346771
summer,1968,Tel Aviv,Israel,Denmark,DEN,0,0,0,0,7,1,8,5795780,56.26392,9.501785
summer,1968,Tel Aviv,Israel,Ethiopia,ETH,0,0,0,0,2,0,2,115434444,9.145,40.489673
summer,1968,Tel Aviv,Israel,Finland,FIN,0,0,0,0,2,0,2,5542237,61.92411,25.748151
summer,1968,Tel Aviv,Israel,France,FRA,13,10,9,32,40,14,54,65298930,46.227638,2.213749
summer,1968,Tel Aviv,Israel,Great Britain,GBR,29,20,20,69,50,24,74,67948282,55.378051,-3.435973
summer,1968,Tel Aviv,Israel,India,IND,0,0,0,0,8,2,10,1382345085,20.593684,78.96288
summer,1968,Tel Aviv,Israel,Ireland,IRL,0,4,5,9,5,2,7,4947267,53.41291,-8.24389
summer,1968,Tel Aviv,Israel,Israel,ISR,18,21,23,62,38,16,54,8678517,31.046051,34.851612
summer,1968,Tel Aviv,Israel,Italy,ITA,12,10,17,39,33,5,38,60446035,41.87194,12.56738
summer,1968,Tel Aviv,Israel,Jamaica,JAM,3,1,1,5,7,4,11,2963429,18.109581,-77.297508
summer,1968,Tel Aviv,Israel,Japan,JPN,2,2,8,12,40,7,47,126407422,36.204824,138.252924
summer,1968,Tel Aviv,Israel,South Korea,KOR,0,0,0,0,5,0,5,51276977,35.907757,127.766922
summer,1968,Tel Aviv,Israel,Malta,MLT,0,0,0,0,4,2,6,441750,35.937496,14.375416
summer,1968,Tel Aviv,Israel,Netherlands,NED,12,4,4,20,24,11,35,17141544,52.132633,5.291266
summer,1968,Tel Aviv,Israel,New Zealand,NZL,1,2,1,4,17,1,18,4829021,-40.900557,174.885971
summer,1968,Tel Aviv,Israel,Norway,NOR,5,3,1,9,18,9,27,5428594,60.472024,8.468946
summer,1968,Tel Aviv,Israel,Rhodesia,ZIM,6,7,7,20,7,7,14,7980000,-19.016666,30.016666
summer,1968,Tel Aviv,Israel,South Africa,RSA,9,10,7,26,5,3,8,59436725,-30.559482,22.937506
summer,1968,Tel Aviv,Israel,Spain,ESP,0,3,1,4,9,2,11,46757980,40.463667,-3.74922
summer,1968,Tel Aviv,Israel,Sweden,SWE,1,6,4,11,27,5,32,10110233,60.128161,18.643501
summer,1968,Tel Aviv,Israel,Switzerland,SUI,0,2,6,8,32,2,34,8665615,46.818188,8.227512
summer,1968,Tel Aviv,Israel,United States of America ,USA,33,27,39,99,53,29,82,#N/A,#N/A,#N/A
summer,1968,Tel Aviv,Israel,Germany,FRG,12,12,11,35,50,8,58,83830972,51.165691,10.451526
summer,1972,Heidelberg,Germany,Argentina,ARG,2,4,3,9,12,9,21,45267449,-38.416097,-63.616672
summer,1972,Heidelberg,Germany,Australia,AUS,6,9,10,25,28,9,37,25550683,-25.274398,133.775136
summer,1972,Heidelberg,Germany,Austria,AUT,6,6,6,18,22,10,32,9015361,47.516231,14.550072
summer,1972,Heidelberg,Germany,Bahamas,BAH,0,0,0,0,1,0,1,393893,25.03428,-77.39628
summer,1972,Heidelberg,Germany,Belgium,BEL,1,1,2,4,18,5,23,11598451,50.503887,4.469936
summer,1972,Heidelberg,Germany,Brazil,BRA,0,0,0,0,8,0,8,212821986,-14.235004,-51.92528
summer,1972,Heidelberg,Germany,Canada,CAN,5,6,8,19,27,13,40,37799407,56.130366,-106.346771
summer,1972,Heidelberg,Germany,Czechoslovakia,TCH,0,0,1,1,14,5,19,10732559,50.073658,14.41854
summer,1972,Heidelberg,Germany,Denmark,DEN,0,0,0,0,8,2,10,5795780,56.26392,9.501785
summer,1972,Heidelberg,Germany,Egypt,EGY,0,0,0,0,1,0,1,102659126,26.820553,30.802498
summer,1972,Heidelberg,Germany,Finland,FIN,0,2,1,3,20,4,24,5542237,61.92411,25.748151
summer,1972,Heidelberg,Germany,France,FRA,10,8,15,33,42,19,61,65298930,46.227638,2.213749
summer,1972,Heidelberg,Germany,Great Britain,GBR,16,15,21,52,48,25,73,67948282,55.378051,-3.435973
summer,1972,Heidelberg,Germany,"Hong Kong, China",HKG,0,1,1,2,10,0,10,7507523,22.396428,114.109497
summer,1972,Heidelberg,Germany,Hungary,HUN,0,0,1,1,4,1,5,9655983,47.162494,19.503304
summer,1972,Heidelberg,Germany,India,IND,1,0,0,1,7,3,10,1382345085,20.593684,78.96288
summer,1972,Heidelberg,Germany,Ireland,IRL,2,4,2,8,8,9,17,4947267,53.41291,-8.24389
summer,1972,Heidelberg,Germany,Israel,ISR,9,10,9,28,19,11,30,8678517,31.046051,34.851612
summer,1972,Heidelberg,Germany,Italy,ITA,8,4,5,17,20,5,25,60446035,41.87194,12.56738
summer,1972,Heidelberg,Germany,Jamaica,JAM,8,3,4,15,13,7,20,2963429,18.109581,-77.297508
summer,1972,Heidelberg,Germany,Japan,JPN,4,5,3,12,23,5,28,126407422,36.204824,138.252924
summer,1972,Heidelberg,Germany,Kenya,KEN,1,0,0,1,4,0,4,53968739,-0.023559,37.906193
summer,1972,Heidelberg,Germany,South Korea,KOR,4,2,1,7,7,1,8,51276977,35.907757,127.766922
summer,1972,Heidelberg,Germany,Malaysia,MAS,0,0,0,0,4,0,4,32436963,4.210484,101.975766
summer,1972,Heidelberg,Germany,Malta,MLT,0,0,0,0,5,3,8,441750,35.937496,14.375416
summer,1972,Heidelberg,Germany,Mexico,MEX,0,0,0,0,7,0,7,129166028,23.634501,-102.552784
summer,1972,Heidelberg,Germany,Netherlands,NED,14,13,11,38,26,12,38,17141544,52.132633,5.291266
summer,1972,Heidelberg,Germany,New Zealand,NZL,3,3,3,9,7,3,10,4829021,-40.900557,174.885971
summer,1972,Heidelberg,Germany,Norway,NOR,1,5,4,10,18,9,27,5428594,60.472024,8.468946
summer,1972,Heidelberg,Germany,Peru,PER,0,0,0,0,1,0,1,33050211,-9.189967,-75.015152
summer,1972,Heidelberg,Germany,Poland,POL,14,12,7,33,12,10,22,37839255,51.919438,19.145136
summer,1972,Heidelberg,Germany,Rhodesia,ZIM,3,5,4,12,6,7,13,7980000,-19.016666,30.016666
summer,1972,Heidelberg,Germany,Romania,ROU,0,0,0,0,1,0,1,19214608,45.943161,24.96676
summer,1972,Heidelberg,Germany,South Africa,RSA,16,12,13,41,12,13,25,59436725,-30.559482,22.937506
summer,1972,Heidelberg,Germany,Spain,ESP,0,4,0,4,11,9,20,46757980,40.463667,-3.74922
summer,1972,Heidelberg,Germany,Sweden,SWE,5,6,6,17,30,8,38,10110233,60.128161,18.643501
summer,1972,Heidelberg,Germany,Switzerland,SUI,3,2,4,9,32,4,36,8665615,46.818188,8.227512
summer,1972,Heidelberg,Germany,Uganda,UGA,0,0,0,0,2,0,2,45974931,1.373333,32.290275
summer,1972,Heidelberg,Germany,United States of America ,USA,17,27,31,75,49,17,66,#N/A,#N/A,#N/A
summer,1972,Heidelberg,Germany,Germany,FRG,28,17,22,67,52,23,75,83830972,51.165691,10.451526
summer,1972,Heidelberg,Germany,Yugoslavia,YUG,1,1,2,4,15,7,22,23528230,14.48329,121.02138
summer,1976,Toronto,Canada,Argentina,ARG,3,4,7,14,8,12,20,45267449,-38.416097,-63.616672
summer,1976,Toronto,Canada,Australia,AUS,16,18,7,41,35,11,46,25550683,-25.274398,133.775136
summer,1976,Toronto,Canada,Austria,AUT,18,16,17,51,32,10,42,9015361,47.516231,14.550072
summer,1976,Toronto,Canada,Bahamas,BAH,0,0,0,0,6,0,6,393893,25.03428,-77.39628
summer,1976,Toronto,Canada,Belgium,BEL,7,7,8,22,41,4,45,11598451,50.503887,4.469936
summer,1976,Toronto,Canada,Brazil,BRA,0,1,0,1,21,2,23,212821986,-14.235004,-51.92528
summer,1976,Toronto,Canada,Myanmar,MYA,1,1,1,3,4,0,4,54473253,21.913965,95.956223
summer,1976,Toronto,Canada,Canada,CAN,25,26,26,77,66,23,89,37799407,56.130366,-106.346771
summer,1976,Toronto,Canada,Colombia,COL,0,0,0,0,8,3,11,50976248,4.570868,-74.297333
summer,1976,Toronto,Canada,Denmark,DEN,3,0,3,6,19,2,21,5795780,56.26392,9.501785
summer,1976,Toronto,Canada,Ecuador,ECU,0,0,0,0,3,0,3,17688599,-1.831239,-78.183406
summer,1976,Toronto,Canada,Egypt,EGY,5,2,1,8,27,0,27,102659126,26.820553,30.802498
summer,1976,Toronto,Canada,Ethiopia,ETH,0,0,0,0,1,0,1,115434444,9.145,40.489673
summer,1976,Toronto,Canada,Fiji,FIJ,0,0,0,0,9,0,9,897573,-16.578193,179.414413
summer,1976,Toronto,Canada,Finland,FIN,12,20,18,50,46,4,50,5542237,61.92411,25.748151
summer,1976,Toronto,Canada,France,FRA,23,21,14,58,42,10,52,65298930,46.227638,2.213749
summer,1976,Toronto,Canada,Great Britain,GBR,29,28,37,94,64,23,87,67948282,55.378051,-3.435973
summer,1976,Toronto,Canada,Greece,GRE,0,0,0,0,3,0,3,10413936,39.074208,21.824312
summer,1976,Toronto,Canada,Guatemala,GUA,0,0,1,1,11,0,11,17971382,15.783471,-90.230759
summer,1976,Toronto,Canada,"Hong Kong, China",HKG,0,1,2,3,11,0,11,7507523,22.396428,114.109497
summer,1976,Toronto,Canada,Hungary,HUN,1,0,1,2,2,0,2,9655983,47.162494,19.503304
summer,1976,Toronto,Canada,Indonesia,INA,2,1,3,6,12,0,12,274021604,-0.789275,113.921327
summer,1976,Toronto,Canada,Ireland,IRL,4,10,6,20,8,11,19,4947267,53.41291,-8.24389
summer,1976,Toronto,Canada,Israel,ISR,40,13,16,69,50,9,59,8678517,31.046051,34.851612
summer,1976,Toronto,Canada,Italy,ITA,2,5,11,18,22,2,24,60446035,41.87194,12.56738
summer,1976,Toronto,Canada,Japan,JPN,10,6,3,19,30,4,34,126407422,36.204824,138.252924
summer,1976,Toronto,Canada,South Korea,KOR,1,2,1,4,7,0,7,51276977,35.907757,127.766922
summer,1976,Toronto,Canada,Luxembourg,LUX,0,0,0,0,2,1,3,627704,49.815273,6.129583
summer,1976,Toronto,Canada,Mexico,MEX,16,14,9,39,24,8,32,129166028,23.634501,-102.552784
summer,1976,Toronto,Canada,Netherlands,NED,45,25,14,84,41,17,58,17141544,52.132633,5.291266
summer,1976,Toronto,Canada,New Zealand,NZL,7,1,5,13,11,1,12,4829021,-40.900557,174.885971
summer,1976,Toronto,Canada,Norway,NOR,9,6,4,19,26,15,41,5428594,60.472024,8.468946
summer,1976,Toronto,Canada,Peru,PER,1,0,2,3,1,1,2,33050211,-9.189967,-75.015152
summer,1976,Toronto,Canada,Poland,POL,24,17,12,53,23,14,37,37839255,51.919438,19.145136
summer,1976,Toronto,Canada,South Africa,RSA,6,9,11,26,27,10,37,59436725,-30.559482,22.937506
summer,1976,Toronto,Canada,Spain,ESP,4,6,2,12,21,1,22,46757980,40.463667,-3.74922
summer,1976,Toronto,Canada,Sweden,SWE,21,28,25,74,56,13,69,10110233,60.128161,18.643501
summer,1976,Toronto,Canada,Switzerland,SUI,9,12,10,31,40,9,49,8665615,46.818188,8.227512
summer,1976,Toronto,Canada,Uganda,UGA,0,0,0,0,1,0,1,45974931,1.373333,32.290275
summer,1976,Toronto,Canada,United States of America ,USA,66,44,45,155,63,34,97,#N/A,#N/A,#N/A
summer,1976,Toronto,Canada,Germany,FRG,37,34,26,97,76,17,93,83830972,51.165691,10.451526
summer,1980,Arnhem,Netherlands,Argentina,ARG,4,5,6,15,6,5,11,45267449,-38.416097,-63.616672
summer,1980,Arnhem,Netherlands,Australia,AUS,12,21,22,55,40,12,52,25550683,-25.274398,133.775136
summer,1980,Arnhem,Netherlands,Austria,AUT,14,23,8,45,38,10,48,9015361,47.516231,14.550072
summer,1980,Arnhem,Netherlands,Bahamas,BAH,0,1,2,3,2,4,6,393893,25.03428,-77.39628
summer,1980,Arnhem,Netherlands,Belgium,BEL,13,12,17,42,54,13,67,11598451,50.503887,4.469936
summer,1980,Arnhem,Netherlands,Brazil,BRA,0,0,0,0,2,0,2,212821986,-14.235004,-51.92528
summer,1980,Arnhem,Netherlands,Canada,CAN,64,35,31,130,60,34,94,37799407,56.130366,-106.346771
summer,1980,Arnhem,Netherlands,Colombia,COL,1,0,1,2,8,3,11,50976248,4.570868,-74.297333
summer,1980,Arnhem,Netherlands,Czechoslovakia,TCH,0,1,1,2,5,2,7,10732559,50.073658,14.41854
summer,1980,Arnhem,Netherlands,Denmark,DEN,6,4,7,17,32,10,42,5795780,56.26392,9.501785
summer,1980,Arnhem,Netherlands,Egypt,EGY,4,7,3,14,26,7,33,102659126,26.820553,30.802498
summer,1980,Arnhem,Netherlands,Ethiopia,ETH,0,0,0,0,1,0,1,115434444,9.145,40.489673
summer,1980,Arnhem,Netherlands,Finland,FIN,8,19,13,40,50,10,60,5542237,61.92411,25.748151
summer,1980,Arnhem,Netherlands,France,FRA,28,26,31,85,76,21,97,65298930,46.227638,2.213749
summer,1980,Arnhem,Netherlands,Great Britain,GBR,47,32,21,100,65,31,96,67948282,55.378051,-3.435973
summer,1980,Arnhem,Netherlands,Greece,GRE,0,0,1,1,6,1,7,10413936,39.074208,21.824312
summer,1980,Arnhem,Netherlands,"Hong Kong, China",HKG,0,1,2,3,11,0,11,7507523,22.396428,114.109497
summer,1980,Arnhem,Netherlands,Iceland,ISL,1,0,1,2,8,4,12,341628,64.963051,-19.020835
summer,1980,Arnhem,Netherlands,Indonesia,INA,2,0,4,6,15,0,15,274021604,-0.789275,113.921327
summer,1980,Arnhem,Netherlands,Ireland,IRL,4,2,11,17,14,9,23,4947267,53.41291,-8.24389
summer,1980,Arnhem,Netherlands,Israel,ISR,13,18,15,46,40,7,47,8678517,31.046051,34.851612
summer,1980,Arnhem,Netherlands,Italy,ITA,6,5,9,20,29,9,38,60446035,41.87194,12.56738
summer,1980,Arnhem,Netherlands,Jamaica,JAM,7,7,5,19,6,7,13,2963429,18.109581,-77.297508
summer,1980,Arnhem,Netherlands,Japan,JPN,9,10,7,26,24,6,30,126407422,36.204824,138.252924
summer,1980,Arnhem,Netherlands,Kenya,KEN,1,2,0,3,13,4,17,53968739,-0.023559,37.906193
summer,1980,Arnhem,Netherlands,South Korea,KOR,2,2,1,5,12,0,12,51276977,35.907757,127.766922
summer,1980,Arnhem,Netherlands,Kuwait,KUW,2,2,1,5,7,2,9,4281320,29.31166,47.481766
summer,1980,Arnhem,Netherlands,Luxembourg,LUX,0,0,1,1,8,1,9,627704,49.815273,6.129583
summer,1980,Arnhem,Netherlands,Malta,MLT,0,0,1,1,5,3,8,441750,35.937496,14.375416
summer,1980,Arnhem,Netherlands,Mexico,MEX,20,16,6,42,19,8,27,129166028,23.634501,-102.552784
summer,1980,Arnhem,Netherlands,Netherlands,NED,33,31,36,100,78,30,108,17141544,52.132633,5.291266
summer,1980,Arnhem,Netherlands,New Zealand,NZL,7,6,6,19,12,5,17,4829021,-40.900557,174.885971
summer,1980,Arnhem,Netherlands,Norway,NOR,15,13,8,36,36,17,53,5428594,60.472024,8.468946
summer,1980,Arnhem,Netherlands,Poland,POL,75,50,52,177,50,30,80,37839255,51.919438,19.145136
summer,1980,Arnhem,Netherlands,Spain,ESP,1,13,9,23,17,7,24,46757980,40.463667,-3.74922
summer,1980,Arnhem,Netherlands,Sudan,SUD,1,0,0,1,8,3,11,44019263,12.862807,30.217636
summer,1980,Arnhem,Netherlands,Sweden,SWE,31,36,24,91,75,19,94,10110233,60.128161,18.643501
summer,1980,Arnhem,Netherlands,Switzerland,SUI,9,10,10,29,51,14,65,8665615,46.818188,8.227512
summer,1980,Arnhem,Netherlands,United States of America ,USA,75,66,54,195,85,47,132,#N/A,#N/A,#N/A
summer,1980,Arnhem,Netherlands,Germany,FRG,68,48,46,162,104,24,128,83830972,51.165691,10.451526
summer,1980,Arnhem,Netherlands,Yugoslavia,YUG,4,5,9,18,25,6,31,23528230,14.48329,121.02138
summer,1980,Arnhem,Netherlands,Zimbabwe,ZIM,0,8,4,12,2,3,5,14899771,-19.015438,29.154857
summer,1984,"Stoke Mandeville, New York","Great Britain, United States of America ",Argentina,ARG,0,0,0,0,6,0,6,45267449,-38.416097,-63.616672
summer,1984,"Stoke Mandeville, New York","Great Britain, United States of America ",Australia,AUS,49,54,51,154,80,28,108,25550683,-25.274398,133.775136
summer,1984,"Stoke Mandeville, New York","Great Britain, United States of America ",Austria,AUT,14,20,10,44,37,8,45,9015361,47.516231,14.550072
summer,1984,"Stoke Mandeville, New York","Great Britain, United States of America ",Bahamas,BAH,0,1,1,2,0,2,2,393893,25.03428,-77.39628
summer,1984,"Stoke Mandeville, New York","Great Britain, United States of America ",Bahrain,BRN,0,0,2,2,10,2,12,1711057,25.930414,50.637772
summer,1984,"Stoke Mandeville, New York","Great Britain, United States of America ",Belgium,BEL,21,23,14,58,30,5,35,11598451,50.503887,4.469936
summer,1984,"Stoke Mandeville, New York","Great Britain, United States of America ",Brazil,BRA,7,17,4,28,24,6,30,212821986,-14.235004,-51.92528
summer,1984,"Stoke Mandeville, New York","Great Britain, United States of America ",Myanmar,MYA,1,2,1,4,10,0,10,54473253,21.913965,95.956223
summer,1984,"Stoke Mandeville, New York","Great Britain, United States of America ",Canada,CAN,87,82,69,238,120,46,166,37799407,56.130366,-106.346771
summer,1984,"Stoke Mandeville, New York","Great Britain, United States of America ",China,CHN,2,12,8,22,17,6,23,1440297825,35.86166,104.195397
summer,1984,"Stoke Mandeville, New York","Great Britain, United States of America ",Denmark,DEN,30,13,16,59,26,10,36,5795780,56.26392,9.501785
summer,1984,"Stoke Mandeville, New York","Great Britain, United States of America ",Germany,GDR,0,3,1,4,3,1,4,83830972,51.165691,10.451526
summer,1984,"Stoke Mandeville, New York","Great Britain, United States of America ",Ecuador,ECU,0,0,0,0,2,0,2,17688599,-1.831239,-78.183406
summer,1984,"Stoke Mandeville, New York","Great Britain, United States of America ",Egypt,EGY,1,1,5,7,25,3,28,102659126,26.820553,30.802498
summer,1984,"Stoke Mandeville, New York","Great Britain, United States of America ",Faroe Islands,FRO,0,0,0,0,1,2,3,48678,61.892635,-6.911806
summer,1984,"Stoke Mandeville, New York","Great Britain, United States of America ",Finland,FIN,18,14,27,59,49,8,57,5542237,61.92411,25.748151
summer,1984,"Stoke Mandeville, New York","Great Britain, United States of America ",France,FRA,71,69,46,186,78,37,115,65298930,46.227638,2.213749
summer,1984,"Stoke Mandeville, New York","Great Britain, United States of America ",Great Britain,GBR,107,112,112,331,156,68,224,67948282,55.378051,-3.435973
summer,1984,"Stoke Mandeville, New York","Great Britain, United States of America ",Greece,GRE,0,0,0,0,2,1,3,10413936,39.074208,21.824312
summer,1984,"Stoke Mandeville, New York","Great Britain, United States of America ",Guatemala,GUA,0,0,0,0,4,0,4,17971382,15.783471,-90.230759
summer,1984,"Stoke Mandeville, New York","Great Britain, United States of America ","Hong Kong, China",HKG,3,5,9,17,14,11,25,7507523,22.396428,114.109497
summer,1984,"Stoke Mandeville, New York","Great Britain, United States of America ",Hungary,HUN,12,13,3,28,22,4,26,9655983,47.162494,19.503304
summer,1984,"Stoke Mandeville, New York","Great Britain, United States of America ",Iceland,ISL,0,2,8,10,8,5,13,341628,64.963051,-19.020835
summer,1984,"Stoke Mandeville, New York","Great Britain, United States of America ",India,IND,0,2,2,4,5,0,5,1382345085,20.593684,78.96288
summer,1984,"Stoke Mandeville, New York","Great Britain, United States of America ",Indonesia,INA,0,1,1,2,6,2,8,274021604,-0.789275,113.921327
summer,1984,"Stoke Mandeville, New York","Great Britain, United States of America ",Ireland,IRL,20,15,31,66,38,13,51,4947267,53.41291,-8.24389
summer,1984,"Stoke Mandeville, New York","Great Britain, United States of America ",Israel,ISR,11,21,12,44,41,6,47,8678517,31.046051,34.851612
summer,1984,"Stoke Mandeville, New York","Great Britain, United States of America ",Italy,ITA,9,19,14,42,47,13,60,60446035,41.87194,12.56738
summer,1984,"Stoke Mandeville, New York","Great Britain, United States of America ",Jamaica,JAM,0,0,0,0,1,0,1,2963429,18.109581,-77.297508
summer,1984,"Stoke Mandeville, New York","Great Britain, United States of America ",Japan,JPN,9,7,8,24,27,10,37,126407422,36.204824,138.252924
summer,1984,"Stoke Mandeville, New York","Great Britain, United States of America ",Jordan,JOR,0,1,2,3,6,3,9,10220604,30.585164,36.238414
summer,1984,"Stoke Mandeville, New York","Great Britain, United States of America ",Kenya,KEN,1,1,1,3,11,2,13,53968739,-0.023559,37.906193
summer,1984,"Stoke Mandeville, New York","Great Britain, United States of America ",South Korea,KOR,0,2,2,4,15,3,18,51276977,35.907757,127.766922
summer,1984,"Stoke Mandeville, New York","Great Britain, United States of America ",Kuwait,KUW,1,3,4,8,20,2,22,4281320,29.31166,47.481766
summer,1984,"Stoke Mandeville, New York","Great Britain, United States of America ",Liechtenstein,LIE,0,0,0,0,0,1,1,38147,47.166,9.555373
summer,1984,"Stoke Mandeville, New York","Great Britain, United States of America ",Luxembourg,LUX,1,4,1,6,5,0,5,627704,49.815273,6.129583
summer,1984,"Stoke Mandeville, New York","Great Britain, United States of America ",Malta,MLT,0,0,0,0,1,0,1,441750,35.937496,14.375416
summer,1984,"Stoke Mandeville, New York","Great Britain, United States of America ",Mexico,MEX,6,14,17,37,40,14,54,129166028,23.634501,-102.552784
summer,1984,"Stoke Mandeville, New York","Great Britain, United States of America ",Netherlands,NED,55,52,28,135,40,21,61,17141544,52.132633,5.291266
summer,1984,"Stoke Mandeville, New York","Great Britain, United States of America ",New Zealand,NZL,8,10,7,25,9,4,13,4829021,-40.900557,174.885971
summer,1984,"Stoke Mandeville, New York","Great Britain, United States of America ",Norway,NOR,30,30,30,90,42,22,64,5428594,60.472024,8.468946
summer,1984,"Stoke Mandeville, New York","Great Britain, United States of America ",Papua New Guinea,PNG,0,0,0,0,4,0,4,8975531,-6.314993,143.95555
summer,1984,"Stoke Mandeville, New York","Great Britain, United States of America ",Poland,POL,46,39,21,106,25,9,34,37839255,51.919438,19.145136
summer,1984,"Stoke Mandeville, New York","Great Britain, United States of America ",Portugal,POR,4,3,7,14,15,2,17,10191409,39.399872,-8.224454
summer,1984,"Stoke Mandeville, New York","Great Britain, United States of America ",Spain,ESP,22,10,12,44,20,9,29,46757980,40.463667,-3.74922
summer,1984,"Stoke Mandeville, New York","Great Britain, United States of America ",Sweden,SWE,83,43,34,160,79,18,97,10110233,60.128161,18.643501
summer,1984,"Stoke Mandeville, New York","Great Britain, United States of America ",Switzerland,SUI,18,13,12,43,35,8,43,8665615,46.818188,8.227512
summer,1984,"Stoke Mandeville, New York","Great Britain, United States of America ",Thailand,THA,0,0,0,0,4,0,4,69830779,15.870032,100.992541
summer,1984,"Stoke Mandeville, New York","Great Britain, United States of America ",Trinidad and Tobago,TTO,2,0,1,3,7,1,8,1400283,10.691803,-61.222503
summer,1984,"Stoke Mandeville, New York","Great Britain, United States of America ",United States of America ,USA,137,131,129,397,157,79,236,#N/A,#N/A,#N/A
summer,1984,"Stoke Mandeville, New York","Great Britain, United States of America ",Venezuela,VEN,0,0,0,0,6,0,6,28421581,6.42375,-66.58973
summer,1984,"Stoke Mandeville, New York","Great Britain, United States of America ",Germany,FRG,81,76,75,232,109,33,142,83830972,51.165691,10.451526
summer,1984,"Stoke Mandeville, New York","Great Britain, United States of America ",Yugoslavia,YUG,11,10,11,32,25,5,30,23528230,14.48329,121.02138
summer,1984,"Stoke Mandeville, New York","Great Britain, United States of America ",Zimbabwe,ZIM,0,1,2,3,5,3,8,14899771,-19.015438,29.154857
summer,1988,Seoul,South Korea,Argentina,ARG,0,7,2,9,18,17,35,45267449,-38.416097,-63.616672
summer,1988,Seoul,South Korea,Australia,AUS,23,34,38,95,148,27,175,25550683,-25.274398,133.775136
summer,1988,Seoul,South Korea,Austria,AUT,13,7,15,35,37,6,43,9015361,47.516231,14.550072
summer,1988,Seoul,South Korea,Bahamas,BAH,0,0,0,0,2,2,4,393893,25.03428,-77.39628
summer,1988,Seoul,South Korea,Bahrain,BRN,1,1,1,3,11,0,11,1711057,25.930414,50.637772
summer,1988,Seoul,South Korea,Belgium,BEL,15,18,8,41,46,8,54,11598451,50.503887,4.469936
summer,1988,Seoul,South Korea,Brazil,BRA,4,9,14,27,47,12,59,212821986,-14.235004,-51.92528
summer,1988,Seoul,South Korea,Bulgaria,BUL,2,1,0,3,8,0,8,6939018,42.733883,25.48583
summer,1988,Seoul,South Korea,Canada,CAN,55,42,55,152,104,53,157,37799407,56.130366,-106.346771
summer,1988,Seoul,South Korea,China,CHN,16,17,8,41,27,14,41,1440297825,35.86166,104.195397
summer,1988,Seoul,South Korea,Colombia,COL,0,0,0,0,16,0,16,50976248,4.570868,-74.297333
summer,1988,Seoul,South Korea,Cyprus,CYP,0,0,0,0,6,0,6,1208886,35.126413,33.429859
summer,1988,Seoul,South Korea,Czechoslovakia,TCH,0,1,0,1,1,0,1,10732559,50.073658,14.41854
summer,1988,Seoul,South Korea,Denmark,DEN,23,19,22,64,27,21,48,5795780,56.26392,9.501785
summer,1988,Seoul,South Korea,Egypt,EGY,1,3,3,7,45,1,46,102659126,26.820553,30.802498
summer,1988,Seoul,South Korea,Faroe Islands,FRO,1,3,3,7,1,3,4,48678,61.892635,-6.911806
summer,1988,Seoul,South Korea,Finland,FIN,11,23,16,50,50,11,61,5542237,61.92411,25.748151
summer,1988,Seoul,South Korea,France,FRA,46,44,50,140,95,21,116,65298930,46.227638,2.213749
summer,1988,Seoul,South Korea,Great Britain,GBR,65,65,54,184,169,55,224,67948282,55.378051,-3.435973
summer,1988,Seoul,South Korea,Greece,GRE,0,1,3,4,4,0,4,10413936,39.074208,21.824312
summer,1988,Seoul,South Korea,Guatemala,GUA,1,0,0,1,1,0,1,17971382,15.783471,-90.230759
summer,1988,Seoul,South Korea,"Hong Kong, China",HKG,0,2,7,9,31,11,42,7507523,22.396428,114.109497
summer,1988,Seoul,South Korea,Hungary,HUN,0,5,7,12,31,3,34,9655983,47.162494,19.503304
summer,1988,Seoul,South Korea,Iceland,ISL,2,2,7,11,9,5,14,341628,64.963051,-19.020835
summer,1988,Seoul,South Korea,India,IND,0,0,0,0,1,1,2,1382345085,20.593684,78.96288
summer,1988,Seoul,South Korea,Indonesia,INA,0,2,0,2,17,2,19,274021604,-0.789275,113.921327
summer,1988,Seoul,South Korea,Iran,IRI,4,1,3,8,36,0,36,84176929,32.427908,53.688046
summer,1988,Seoul,South Korea,Ireland,IRL,13,11,18,42,42,11,53,4947267,53.41291,-8.24389
summer,1988,Seoul,South Korea,Israel,ISR,15,14,16,45,47,15,62,8678517,31.046051,34.851612
summer,1988,Seoul,South Korea,Italy,ITA,16,15,27,58,69,26,95,60446035,41.87194,12.56738
summer,1988,Seoul,South Korea,Jamaica,JAM,1,4,3,8,2,3,5,2963429,18.109581,-77.297508
summer,1988,Seoul,South Korea,Japan,JPN,17,12,17,46,109,34,143,126407422,36.204824,138.252924
summer,1988,Seoul,South Korea,Jordan,JOR,0,0,0,0,5,2,7,10220604,30.585164,36.238414
summer,1988,Seoul,South Korea,Kenya,KEN,0,4,1,5,9,3,12,53968739,-0.023559,37.906193
summer,1988,Seoul,South Korea,South Korea,KOR,40,35,19,94,205,21,226,51276977,35.907757,127.766922
summer,1988,Seoul,South Korea,Kuwait,KUW,5,5,7,17,27,3,30,4281320,29.31166,47.481766
summer,1988,Seoul,South Korea,Liechtenstein,LIE,0,0,0,0,1,1,2,38147,47.166,9.555373
summer,1988,Seoul,South Korea,"Macao, China",MAC,0,0,0,0,6,1,7,650846,22.210928,113.552971
summer,1988,Seoul,South Korea,Malaysia,MAS,0,0,1,1,12,2,14,32436963,4.210484,101.975766
summer,1988,Seoul,South Korea,Mexico,MEX,8,9,7,24,28,5,33,129166028,23.634501,-102.552784
summer,1988,Seoul,South Korea,Morocco,MAR,0,0,1,1,14,0,14,36985624,31.791702,-7.09262
summer,1988,Seoul,South Korea,Netherlands,NED,30,24,29,83,76,34,110,17141544,52.132633,5.291266
summer,1988,Seoul,South Korea,New Zealand,NZL,2,4,11,17,11,5,16,4829021,-40.900557,174.885971
summer,1988,Seoul,South Korea,Norway,NOR,11,11,15,37,28,6,34,5428594,60.472024,8.468946
summer,1988,Seoul,South Korea,Oman,OMA,0,0,0,0,9,0,9,5128058,21.512583,55.923255
summer,1988,Seoul,South Korea,Philippines,PHI,0,0,0,0,4,0,4,109830324,12.879721,121.774017
summer,1988,Seoul,South Korea,Poland,POL,23,25,33,81,39,7,46,37839255,51.919438,19.145136
summer,1988,Seoul,South Korea,Portugal,POR,3,5,6,14,7,6,13,10191409,39.399872,-8.224454
summer,1988,Seoul,South Korea,Puerto Rico,PUR,1,2,0,3,12,1,13,2846860,18.220833,-66.590149
summer,1988,Seoul,South Korea,Singapore,SGP,0,0,0,0,7,1,8,5858322,1.352083,103.819836
summer,1988,Seoul,South Korea,Spain,ESP,18,13,12,43,42,8,50,46757980,40.463667,-3.74922
summer,1988,Seoul,South Korea,Sweden,SWE,42,38,23,103,79,24,103,10110233,60.128161,18.643501
summer,1988,Seoul,South Korea,Switzerland,SUI,12,12,11,35,33,8,41,8665615,46.818188,8.227512
summer,1988,Seoul,South Korea,Thailand,THA,0,1,0,1,10,0,10,69830779,15.870032,100.992541
summer,1988,Seoul,South Korea,Trinidad and Tobago,TTO,0,0,0,0,4,0,4,1400283,10.691803,-61.222503
summer,1988,Seoul,South Korea,Tunisia,TUN,0,0,2,2,1,0,1,11839918,33.886917,9.537499
summer,1988,Seoul,South Korea,United States of America ,USA,91,90,88,269,253,118,371,#N/A,#N/A,#N/A
summer,1988,Seoul,South Korea,USSR,URS,21,20,15,56,16,6,22,262436000,37.09024,-95.712891
summer,1988,Seoul,South Korea,Germany,FRG,76,65,52,193,145,43,188,83830972,51.165691,10.451526
summer,1988,Seoul,South Korea,Yugoslavia,YUG,4,4,11,19,30,4,34,23528230,14.48329,121.02138
summer,1992,Barcelona,Spain,Algeria,ALG,0,0,0,0,8,0,8,43984569,28.033886,1.659626
summer,1992,Barcelona,Spain,Argentina,ARG,1,1,0,2,26,1,27,45267449,-38.416097,-63.616672
summer,1992,Barcelona,Spain,Australia,AUS,24,27,25,76,93,41,134,25550683,-25.274398,133.775136
summer,1992,Barcelona,Spain,Austria,AUT,5,4,13,22,31,5,36,9015361,47.516231,14.550072
summer,1992,Barcelona,Spain,Bahrain,BRN,0,0,1,1,4,0,4,1711057,25.930414,50.637772
summer,1992,Barcelona,Spain,Belarus,BLR,0,0,0,0,1,0,1,9448772,53.709807,27.953389
summer,1992,Barcelona,Spain,Belgium,BEL,5,5,7,17,64,9,73,11598451,50.503887,4.469936
summer,1992,Barcelona,Spain,Brazil,BRA,3,0,4,7,31,10,41,212821986,-14.235004,-51.92528
summer,1992,Barcelona,Spain,Bulgaria,BUL,1,2,0,3,5,2,7,6939018,42.733883,25.48583
summer,1992,Barcelona,Spain,Burkina Faso,BUR,0,0,0,0,3,0,3,20997293,12.238333,-1.561593
summer,1992,Barcelona,Spain,Canada,CAN,28,21,26,75,89,49,138,37799407,56.130366,-106.346771
summer,1992,Barcelona,Spain,Chile,CHI,0,0,0,0,2,0,2,19144605,-35.675147,-71.542969
summer,1992,Barcelona,Spain,China,CHN,11,7,7,25,13,11,24,1440297825,35.86166,104.195397
summer,1992,Barcelona,Spain,Chinese Taipei,TPE,0,0,1,1,10,1,11,23816775,25.105497,121.597366
summer,1992,Barcelona,Spain,Colombia,COL,0,0,0,0,4,2,6,50976248,4.570868,-74.297333
summer,1992,Barcelona,Spain,Costa Rica,CRC,0,0,0,0,2,0,2,5102158,9.748917,-83.753428
summer,1992,Barcelona,Spain,Croatia,CRO,0,0,1,1,5,1,6,4100719,45.1,15.2
summer,1992,Barcelona,Spain,Cuba,CUB,3,3,3,9,10,0,10,11325391,21.521757,-77.781167
summer,1992,Barcelona,Spain,Cyprus,CYP,0,0,0,0,4,0,4,1208886,35.126413,33.429859
summer,1992,Barcelona,Spain,Czechoslovakia,TCH,4,3,6,13,24,5,29,10732559,50.073658,14.41854
summer,1992,Barcelona,Spain,Denmark,DEN,12,22,12,46,22,21,43,5795780,56.26392,9.501785
summer,1992,Barcelona,Spain,Dominican Republic,DOM,0,0,0,0,1,0,1,10866667,18.735693,-70.162651
summer,1992,Barcelona,Spain,Ecuador,ECU,0,0,0,0,3,0,3,17688599,-1.831239,-78.183406
summer,1992,Barcelona,Spain,Egypt,EGY,7,6,7,20,41,0,41,102659126,26.820553,30.802498
summer,1992,Barcelona,Spain,Estonia,EST,0,2,1,3,2,4,6,1326693,58.595272,25.013607
summer,1992,Barcelona,Spain,Faroe Islands,FRO,0,1,0,1,1,2,3,48678,61.892635,-6.911806
summer,1992,Barcelona,Spain,Finland,FIN,8,6,11,25,54,13,67,5542237,61.92411,25.748151
summer,1992,Barcelona,Spain,France,FRA,36,36,34,106,106,39,145,65298930,46.227638,2.213749
summer,1992,Barcelona,Spain,Germany,GER,61,51,59,171,174,64,238,83830972,51.165691,10.451526
summer,1992,Barcelona,Spain,Great Britain,GBR,40,47,41,128,156,52,208,67948282,55.378051,-3.435973
summer,1992,Barcelona,Spain,Greece,GRE,0,2,1,3,7,0,7,10413936,39.074208,21.824312
summer,1992,Barcelona,Spain,"Hong Kong, China",HKG,3,4,4,11,16,5,21,7507523,22.396428,114.109497
summer,1992,Barcelona,Spain,Hungary,HUN,4,3,4,11,34,9,43,9655983,47.162494,19.503304
summer,1992,Barcelona,Spain,Iceland,ISL,3,2,12,17,8,4,12,341628,64.963051,-19.020835
summer,1992,Barcelona,Spain,India,IND,0,0,0,0,7,2,9,1382345085,20.593684,78.96288
summer,1992,Barcelona,Spain,Iran,IRI,1,2,1,4,25,4,29,84176929,32.427908,53.688046
summer,1992,Barcelona,Spain,Iraq,IRQ,0,0,1,1,18,0,18,40372771,33.223191,43.679291
summer,1992,Barcelona,Spain,Ireland,IRL,0,3,4,7,40,18,58,4947267,53.41291,-8.24389
summer,1992,Barcelona,Spain,Israel,ISR,2,4,5,11,56,6,62,8678517,31.046051,34.851612
summer,1992,Barcelona,Spain,Italy,ITA,10,7,18,35,69,18,87,60446035,41.87194,12.56738
summer,1992,Barcelona,Spain,Jamaica,JAM,0,1,2,3,2,2,4,2963429,18.109581,-77.297508
summer,1992,Barcelona,Spain,Japan,JPN,8,7,15,30,54,22,76,126407422,36.204824,138.252924
summer,1992,Barcelona,Spain,Kenya,KEN,1,0,1,2,9,6,15,53968739,-0.023559,37.906193
summer,1992,Barcelona,Spain,South Korea,KOR,11,15,18,44,64,2,66,51276977,35.907757,127.766922
summer,1992,Barcelona,Spain,Kuwait,KUW,1,3,1,5,21,3,24,4281320,29.31166,47.481766
summer,1992,Barcelona,Spain,Latvia,LAT,0,0,0,0,2,0,2,1882408,56.879635,24.603189
summer,1992,Barcelona,Spain,Liechtenstein,LIE,0,0,0,0,3,0,3,38147,47.166,9.555373
summer,1992,Barcelona,Spain,Lithuania,LTU,0,4,3,7,1,3,4,2715340,55.169438,23.881275
summer,1992,Barcelona,Spain,Luxembourg,LUX,0,0,0,0,2,0,2,627704,49.815273,6.129583
summer,1992,Barcelona,Spain,"Macao, China",MAC,0,0,0,0,2,0,2,650846,22.210928,113.552971
summer,1992,Barcelona,Spain,Malaysia,MAS,0,1,2,3,10,0,10,32436963,4.210484,101.975766
summer,1992,Barcelona,Spain,Mexico,MEX,0,1,10,11,9,10,19,129166028,23.634501,-102.552784
summer,1992,Barcelona,Spain,Morocco,MAR,0,0,0,0,5,0,5,36985624,31.791702,-7.09262
summer,1992,Barcelona,Spain,Myanmar,MYA,0,0,0,0,1,0,1,54473253,21.913965,95.956223
summer,1992,Barcelona,Spain,Namibia,NAM,0,0,0,0,0,2,2,2548663,-22.95764,18.49041
summer,1992,Barcelona,Spain,Netherlands,NED,14,14,11,39,72,27,99,17141544,52.132633,5.291266
summer,1992,Barcelona,Spain,New Zealand,NZL,5,1,0,6,9,4,13,4829021,-40.900557,174.885971
summer,1992,Barcelona,Spain,Nigeria,NGR,3,0,0,3,6,0,6,206984347,9.081999,8.675277
summer,1992,Barcelona,Spain,Norway,NOR,13,13,7,33,33,5,38,5428594,60.472024,8.468946
summer,1992,Barcelona,Spain,Oman,OMA,0,0,0,0,4,0,4,5128058,21.512583,55.923255
summer,1992,Barcelona,Spain,Pakistan,PAK,0,0,0,0,2,0,2,221612785,30.375321,69.345116
summer,1992,Barcelona,Spain,Panama,PAN,1,2,0,3,2,0,2,4326296,8.537981,-80.782127
summer,1992,Barcelona,Spain,Poland,POL,10,12,10,32,36,4,40,37839255,51.919438,19.145136
summer,1992,Barcelona,Spain,Portugal,POR,3,3,3,9,26,4,30,10191409,39.399872,-8.224454
summer,1992,Barcelona,Spain,Puerto Rico,PUR,0,0,0,0,8,1,9,2846860,18.220833,-66.590149
summer,1992,Barcelona,Spain,Seychelles,SEY,0,0,0,0,2,0,2,98453,-4.679574,55.491977
summer,1992,Barcelona,Spain,Singapore,SGP,0,0,0,0,3,1,4,5858322,1.352083,103.819836
summer,1992,Barcelona,Spain,Slovenia,SLO,2,0,1,3,7,1,8,2078989,46.151241,14.995463
summer,1992,Barcelona,Spain,South Africa,RSA,4,1,3,8,9,1,10,59436725,-30.559482,22.937506
summer,1992,Barcelona,Spain,Spain,ESP,34,31,42,107,167,66,233,46757980,40.463667,-3.74922
summer,1992,Barcelona,Spain,Sweden,SWE,7,22,9,38,72,27,99,10110233,60.128161,18.643501
summer,1992,Barcelona,Spain,Switzerland,SUI,6,16,13,35,36,5,41,8665615,46.818188,8.227512
summer,1992,Barcelona,Spain,Syrian,SYR,0,0,0,0,2,0,2,17500658,34.8149,39.0465
summer,1992,Barcelona,Spain,United Republic of the Tanzania,TAN,0,0,0,0,1,0,1,#N/A,#N/A,#N/A
summer,1992,Barcelona,Spain,Thailand,THA,0,0,1,1,5,0,5,69830779,15.870032,100.992541
summer,1992,Barcelona,Spain,Tunisia,TUN,0,0,0,0,1,0,1,11839918,33.886917,9.537499
summer,1992,Barcelona,Spain,Turkey,TUR,0,0,0,0,1,0,1,84495243,38.963745,35.243322
summer,1992,Barcelona,Spain,United Arab Emirates,UAE,0,0,0,0,1,0,1,9910892,23.424076,53.847818
summer,1992,Barcelona,Spain,United States of America ,USA,75,52,48,175,264,90,354,#N/A,#N/A,#N/A
summer,1992,Barcelona,Spain,Uruguay,URU,0,0,0,0,2,0,2,3475842,-32.522779,-55.765835
summer,1992,Barcelona,Spain,Venezuela,VEN,0,0,1,1,9,1,10,28421581,6.42375,-66.58973
summer,1992,Barcelona,Spain,Yemen,YEM,0,0,0,0,3,0,3,29935468,15.552727,48.516388
summer,1996,Atlanta,United States of America ,Afghanistan,AFG,0,0,0,0,2,0,2,39074280,33.93911,67.709953
summer,1996,Atlanta,United States of America ,Algeria,ALG,2,2,3,7,9,0,9,43984569,28.033886,1.659626
summer,1996,Atlanta,United States of America ,Angola,ANG,0,0,0,0,2,0,2,33032075,-11.202692,17.873887
summer,1996,Atlanta,United States of America ,Argentina,ARG,2,5,2,9,49,7,56,45267449,-38.416097,-63.616672
summer,1996,Atlanta,United States of America ,Armenia,ARM,0,0,0,0,5,0,5,2964219,40.069099,45.038189
summer,1996,Atlanta,United States of America ,Australia,AUS,42,37,27,106,99,62,161,25550683,-25.274398,133.775136
summer,1996,Atlanta,United States of America ,Austria,AUT,6,6,10,22,44,5,49,9015361,47.516231,14.550072
summer,1996,Atlanta,United States of America ,Azerbaijan,AZE,0,0,0,0,2,0,2,10154978,40.143105,47.576927
summer,1996,Atlanta,United States of America ,Bahrain,BRN,0,0,0,0,6,0,6,1711057,25.930414,50.637772
summer,1996,Atlanta,United States of America ,Belarus,BLR,3,3,7,13,11,4,15,9448772,53.709807,27.953389
summer,1996,Atlanta,United States of America ,Belgium,BEL,8,10,7,25,32,6,38,11598451,50.503887,4.469936
summer,1996,Atlanta,United States of America ,Bermuda,BER,0,0,0,0,0,2,2,62237,32.321384,-64.75737
summer,1996,Atlanta,United States of America ,Bosnia and Herzegovina,BIH,0,0,0,0,3,0,3,3277152,43.915886,17.679076
summer,1996,Atlanta,United States of America ,Brazil,BRA,2,6,13,21,41,19,60,212821986,-14.235004,-51.92528
summer,1996,Atlanta,United States of America ,Bulgaria,BUL,0,1,1,2,4,2,6,6939018,42.733883,25.48583
summer,1996,Atlanta,United States of America ,Burkina Faso,BUR,0,0,0,0,3,0,3,20997293,12.238333,-1.561593
summer,1996,Atlanta,United States of America ,Canada,CAN,24,21,24,69,94,38,132,37799407,56.130366,-106.346771
summer,1996,Atlanta,United States of America ,Chile,CHI,0,0,0,0,2,0,2,19144605,-35.675147,-71.542969
summer,1996,Atlanta,United States of America ,China,CHN,16,13,10,39,27,10,37,1440297825,35.86166,104.195397
summer,1996,Atlanta,United States of America ,Chinese Taipei,TPE,1,0,2,3,13,1,14,23816775,25.105497,121.597366
summer,1996,Atlanta,United States of America ,Colombia,COL,0,0,0,0,2,0,2,50976248,4.570868,-74.297333
summer,1996,Atlanta,United States of America ,Côte d'Ivoire,CIV,2,0,0,2,2,0,2,26486282,7.539989,-5.54708
summer,1996,Atlanta,United States of America ,Croatia,CRO,0,0,0,0,2,3,5,4100719,45.1,15.2
summer,1996,Atlanta,United States of America ,Cuba,CUB,8,3,0,11,9,1,10,11325391,21.521757,-77.781167
summer,1996,Atlanta,United States of America ,Cyprus,CYP,0,0,0,0,4,0,4,1208886,35.126413,33.429859
summer,1996,Atlanta,United States of America ,Czech Republic,CZE,2,7,1,10,36,7,43,10712481,49.817492,15.472962
summer,1996,Atlanta,United States of America ,Denmark,DEN,7,17,17,41,25,20,45,5795780,56.26392,9.501785
summer,1996,Atlanta,United States of America ,Dominican Republic,DOM,1,0,0,1,2,0,2,10866667,18.735693,-70.162651
summer,1996,Atlanta,United States of America ,Ecuador,ECU,0,0,0,0,2,0,2,17688599,-1.831239,-78.183406
summer,1996,Atlanta,United States of America ,Egypt,EGY,8,11,11,30,26,5,31,102659126,26.820553,30.802498
summer,1996,Atlanta,United States of America ,Estonia,EST,3,4,2,9,2,8,10,1326693,58.595272,25.013607
summer,1996,Atlanta,United States of America ,Faroe Islands,FRO,0,0,0,0,0,1,1,48678,61.892635,-6.911806
summer,1996,Atlanta,United States of America ,Fiji,FIJ,0,0,0,0,2,0,2,897573,-16.578193,179.414413
summer,1996,Atlanta,United States of America ,Finland,FIN,4,5,4,13,53,12,65,5542237,61.92411,25.748151
summer,1996,Atlanta,United States of America ,France,FRA,35,29,31,95,122,25,147,65298930,46.227638,2.213749
summer,1996,Atlanta,United States of America ,Germany,GER,40,58,51,149,153,78,231,83830972,51.165691,10.451526
summer,1996,Atlanta,United States of America ,Great Britain,GBR,39,42,41,122,165,83,248,67948282,55.378051,-3.435973
summer,1996,Atlanta,United States of America ,Greece,GRE,1,1,3,5,16,0,16,10413936,39.074208,21.824312
summer,1996,Atlanta,United States of America ,Honduras,HON,0,0,0,0,2,0,2,9931333,15.199999,-86.241905
summer,1996,Atlanta,United States of America ,"Hong Kong, China",HKG,5,5,5,15,19,5,24,7507523,22.396428,114.109497
summer,1996,Atlanta,United States of America ,Hungary,HUN,5,2,3,10,32,10,42,9655983,47.162494,19.503304
summer,1996,Atlanta,United States of America ,Iceland,ISL,5,4,5,14,6,4,10,341628,64.963051,-19.020835
summer,1996,Atlanta,United States of America ,India,IND,0,0,0,0,9,0,9,1382345085,20.593684,78.96288
summer,1996,Atlanta,United States of America ,Indonesia,INA,0,0,0,0,1,0,1,274021604,-0.789275,113.921327
summer,1996,Atlanta,United States of America ,Iran,IRI,9,5,3,17,28,2,30,84176929,32.427908,53.688046
summer,1996,Atlanta,United States of America ,Ireland,IRL,1,3,6,10,46,17,63,4947267,53.41291,-8.24389
summer,1996,Atlanta,United States of America ,Israel,ISR,0,4,5,9,37,3,40,8678517,31.046051,34.851612
summer,1996,Atlanta,United States of America ,Italy,ITA,11,20,14,45,59,19,78,60446035,41.87194,12.56738
summer,1996,Atlanta,United States of America ,Jamaica,JAM,0,0,1,1,2,1,3,2963429,18.109581,-77.297508
summer,1996,Atlanta,United States of America ,Japan,JPN,14,10,13,37,58,23,81,126407422,36.204824,138.252924
summer,1996,Atlanta,United States of America ,Jordan,JOR,0,1,0,1,5,0,5,10220604,30.585164,36.238414
summer,1996,Atlanta,United States of America ,Kazakhstan,KAZ,0,0,0,0,13,0,13,18815231,48.019573,66.923684
summer,1996,Atlanta,United States of America ,Kenya,KEN,1,1,0,2,11,6,17,53968739,-0.023559,37.906193
summer,1996,Atlanta,United States of America ,South Korea,KOR,13,2,15,30,55,9,64,51276977,35.907757,127.766922
summer,1996,Atlanta,United States of America ,Kuwait,KUW,1,1,1,3,17,0,17,4281320,29.31166,47.481766
summer,1996,Atlanta,United States of America ,Kyrgyzstan,KGZ,0,0,0,0,2,0,2,6542426,41.20438,74.766098
summer,1996,Atlanta,United States of America ,Latvia,LAT,0,0,0,0,4,1,5,1882408,56.879635,24.603189
summer,1996,Atlanta,United States of America ,Libya,LBA,0,0,0,0,4,0,4,6887247,26.3351,17.228331
summer,1996,Atlanta,United States of America ,Lithuania,LTU,3,2,6,11,6,3,9,2715340,55.169438,23.881275
summer,1996,Atlanta,United States of America ,Luxembourg,LUX,0,0,0,0,1,0,1,627704,49.815273,6.129583
summer,1996,Atlanta,United States of America ,"Macao, China",MAC,0,0,0,0,1,0,1,650846,22.210928,113.552971
summer,1996,Atlanta,United States of America ,Malaysia,MAS,0,0,0,0,6,0,6,32436963,4.210484,101.975766
summer,1996,Atlanta,United States of America ,Mauritius,MRI,0,0,0,0,2,0,2,1272140,-20.348404,57.552152
summer,1996,Atlanta,United States of America ,Mexico,MEX,3,5,4,12,28,10,38,129166028,23.634501,-102.552784
summer,1996,Atlanta,United States of America ,Moldova,MDA,0,0,2,2,5,0,5,4032294,47.411631,28.369885
summer,1996,Atlanta,United States of America ,Morocco,MAR,0,0,0,0,4,0,4,36985624,31.791702,-7.09262
summer,1996,Atlanta,United States of America ,Netherlands,NED,17,11,17,45,73,33,106,17141544,52.132633,5.291266
summer,1996,Atlanta,United States of America ,New Zealand,NZL,9,6,3,18,28,6,34,4829021,-40.900557,174.885971
summer,1996,Atlanta,United States of America ,Nigeria,NGR,3,2,3,8,8,0,8,206984347,9.081999,8.675277
summer,1996,Atlanta,United States of America ,North Macedonia,MKD,0,0,0,0,1,0,1,2083359,41.608635,21.745275
summer,1996,Atlanta,United States of America ,Norway,NOR,9,7,4,20,35,7,42,5428594,60.472024,8.468946
summer,1996,Atlanta,United States of America ,Oman,OMA,0,0,0,0,3,0,3,5128058,21.512583,55.923255
summer,1996,Atlanta,United States of America ,Pakistan,PAK,0,0,0,0,1,0,1,221612785,30.375321,69.345116
summer,1996,Atlanta,United States of America ,Panama,PAN,2,0,0,2,1,0,1,4326296,8.537981,-80.782127
summer,1996,Atlanta,United States of America ,Peru,PER,1,0,0,1,3,0,3,33050211,-9.189967,-75.015152
summer,1996,Atlanta,United States of America ,Poland,POL,13,14,8,35,49,12,61,37839255,51.919438,19.145136
summer,1996,Atlanta,United States of America ,Portugal,POR,6,4,4,14,29,6,35,10191409,39.399872,-8.224454
summer,1996,Atlanta,United States of America ,Puerto Rico,PUR,0,0,0,0,3,2,5,2846860,18.220833,-66.590149
summer,1996,Atlanta,United States of America ,Qatar,QAT,0,0,0,0,1,0,1,2889284,25.354826,51.183884
summer,1996,Atlanta,United States of America ,Romania,ROU,0,0,0,0,1,0,1,19214608,45.943161,24.96676
summer,1996,Atlanta,United States of America ,Russia,RUS,9,7,11,27,60,10,70,145945524,61.52401,105.318756
summer,1996,Atlanta,United States of America ,Saudi Arabia,KSA,0,0,0,0,2,0,2,34905942,23.885942,45.079162
summer,1996,Atlanta,United States of America ,Sierra Leone,SLE,0,0,0,0,1,0,1,8004158,8.460555,-11.779889
summer,1996,Atlanta,United States of America ,Singapore,SGP,0,0,0,0,1,2,3,5858322,1.352083,103.819836
summer,1996,Atlanta,United States of America ,Slovakia,SVK,2,4,5,11,23,5,28,5460109,48.669026,19.699024
summer,1996,Atlanta,United States of America ,Slovenia,SLO,0,2,3,5,13,1,14,2078989,46.151241,14.995463
summer,1996,Atlanta,United States of America ,South Africa,RSA,10,8,10,28,29,11,40,59436725,-30.559482,22.937506
summer,1996,Atlanta,United States of America ,Spain,ESP,39,31,36,106,146,50,196,46757980,40.463667,-3.74922
summer,1996,Atlanta,United States of America ,Sri Lanka,SRI,0,0,0,0,1,0,1,21428970,7.873054,80.771797
summer,1996,Atlanta,United States of America ,Sweden,SWE,12,14,11,37,83,27,110,10110233,60.128161,18.643501
summer,1996,Atlanta,United States of America ,Switzerland,SUI,9,6,6,21,36,9,45,8665615,46.818188,8.227512
summer,1996,Atlanta,United States of America ,Syrian,SYR,0,0,0,0,2,0,2,17500658,34.8149,39.0465
summer,1996,Atlanta,United States of America ,Thailand,THA,0,0,2,2,7,0,7,69830779,15.870032,100.992541
summer,1996,Atlanta,United States of America ,Tunisia,TUN,0,2,0,2,2,1,3,11839918,33.886917,9.537499
summer,1996,Atlanta,United States of America ,Uganda,UGA,0,0,0,0,1,0,1,45974931,1.373333,32.290275
summer,1996,Atlanta,United States of America ,Ukraine,UKR,1,4,2,7,25,5,30,43686577,48.379433,31.16558
summer,1996,Atlanta,United States of America ,United Arab Emirates,UAE,0,0,0,0,5,0,5,9910892,23.424076,53.847818
summer,1996,Atlanta,United States of America ,United States of America ,USA,46,46,65,157,239,89,328,#N/A,#N/A,#N/A
summer,1996,Atlanta,United States of America ,Uruguay,URU,0,0,1,1,1,0,1,3475842,-32.522779,-55.765835
summer,1996,Atlanta,United States of America ,Venezuela,VEN,0,0,0,0,4,0,4,28421581,6.42375,-66.58973
summer,1996,Atlanta,United States of America ,Yugoslavia,YUG,2,2,0,4,5,1,6,23528230,14.48329,121.02138
summer,1996,Atlanta,United States of America ,Zambia,ZAM,0,0,0,0,1,0,1,18468257,-13.133897,27.849332
summer,1996,Atlanta,United States of America ,Zimbabwe,ZIM,0,0,0,0,2,0,2,14899771,-19.015438,29.154857
summer,2000,Sydney,Australia,Algeria,ALG,3,0,0,3,7,1,8,43984569,28.033886,1.659626
summer,2000,Sydney,Australia,Angola,ANG,0,0,0,0,1,0,1,33032075,-11.202692,17.873887
summer,2000,Sydney,Australia,Argentina,ARG,0,2,3,5,31,12,43,45267449,-38.416097,-63.616672
summer,2000,Sydney,Australia,Armenia,ARM,0,0,0,0,4,0,4,2964219,40.069099,45.038189
summer,2000,Sydney,Australia,Australia,AUS,63,39,47,149,193,93,286,25550683,-25.274398,133.775136
summer,2000,Sydney,Australia,Austria,AUT,2,7,6,15,47,5,52,9015361,47.516231,14.550072
summer,2000,Sydney,Australia,Azerbaijan,AZE,0,1,0,1,6,1,7,10154978,40.143105,47.576927
summer,2000,Sydney,Australia,Bahrain,BRN,0,1,1,2,3,0,3,1711057,25.930414,50.637772
summer,2000,Sydney,Australia,Barbados,BAR,0,0,0,0,1,0,1,287437,13.193887,-59.543198
summer,2000,Sydney,Australia,Belarus,BLR,5,8,10,23,15,7,22,9448772,53.709807,27.953389
summer,2000,Sydney,Australia,Belgium,BEL,1,4,4,9,25,5,30,11598451,50.503887,4.469936
summer,2000,Sydney,Australia,Benin,BEN,0,0,0,0,1,0,1,12175480,9.30769,2.315834
summer,2000,Sydney,Australia,Bermuda,BER,0,0,0,0,1,1,2,62237,32.321384,-64.75737
summer,2000,Sydney,Australia,Bosnia and Herzegovina,BIH,0,1,0,1,13,0,13,3277152,43.915886,17.679076
summer,2000,Sydney,Australia,Brazil,BRA,6,10,6,22,52,11,63,212821986,-14.235004,-51.92528
summer,2000,Sydney,Australia,Bulgaria,BUL,1,0,0,1,3,1,4,6939018,42.733883,25.48583
summer,2000,Sydney,Australia,Burkina Faso,BUR,0,0,0,0,1,0,1,20997293,12.238333,-1.561593
summer,2000,Sydney,Australia,Cambodia,CAM,0,0,0,0,11,0,11,16758448,12.565679,104.990963
summer,2000,Sydney,Australia,Canada,CAN,38,33,25,96,112,53,165,37799407,56.130366,-106.346771
summer,2000,Sydney,Australia,Chile,CHI,0,0,0,0,4,0,4,19144605,-35.675147,-71.542969
summer,2000,Sydney,Australia,United States of America ,CHN,34,22,17,73,54,33,87,#N/A,#N/A,#N/A
summer,2000,Sydney,Australia,Chinese Taipei,TPE,1,2,4,7,17,8,25,23816775,25.105497,121.597366
summer,2000,Sydney,Australia,Colombia,COL,0,0,0,0,3,0,3,50976248,4.570868,-74.297333
summer,2000,Sydney,Australia,Costa Rica,CRC,0,0,0,0,1,0,1,5102158,9.748917,-83.753428
summer,2000,Sydney,Australia,Côte d'Ivoire,CIV,1,0,1,2,2,0,2,26486282,7.539989,-5.54708
summer,2000,Sydney,Australia,Croatia,CRO,0,0,0,0,10,5,15,4100719,45.1,15.2
summer,2000,Sydney,Australia,Cuba,CUB,4,2,2,8,9,1,10,11325391,21.521757,-77.781167
summer,2000,Sydney,Australia,Cyprus,CYP,0,0,0,0,3,1,4,1208886,35.126413,33.429859
summer,2000,Sydney,Australia,Czech Republic,CZE,15,15,13,43,41,16,57,10712481,49.817492,15.472962
summer,2000,Sydney,Australia,Denmark,DEN,8,8,14,30,26,12,38,5795780,56.26392,9.501785
summer,2000,Sydney,Australia,Ecuador,ECU,0,0,0,0,2,1,3,17688599,-1.831239,-78.183406
summer,2000,Sydney,Australia,Egypt,EGY,6,12,10,28,33,12,45,102659126,26.820553,30.802498
summer,2000,Sydney,Australia,El Salvador,ESA,0,0,0,0,0,1,1,6491923,13.794185,-88.89653
summer,2000,Sydney,Australia,Estonia,EST,1,1,3,5,4,6,10,1326693,58.595272,25.013607
summer,2000,Sydney,Australia,Faroe Islands,FRO,0,3,1,4,0,2,2,48678,61.892635,-6.911806
summer,2000,Sydney,Australia,Fiji,FIJ,0,0,0,0,4,0,4,897573,-16.578193,179.414413
summer,2000,Sydney,Australia,Finland,FIN,1,3,6,10,38,11,49,5542237,61.92411,25.748151
summer,2000,Sydney,Australia,France,FRA,30,28,28,86,116,30,146,65298930,46.227638,2.213749
summer,2000,Sydney,Australia,Germany,GER,16,41,38,95,181,69,250,83830972,51.165691,10.451526
summer,2000,Sydney,Australia,Great Britain,GBR,41,43,47,131,140,74,214,67948282,55.378051,-3.435973
summer,2000,Sydney,Australia,Greece,GRE,4,4,3,11,41,3,44,10413936,39.074208,21.824312
summer,2000,Sydney,Australia,Honduras,HON,0,0,0,0,1,0,1,9931333,15.199999,-86.241905
summer,2000,Sydney,Australia,"Hong Kong, China",HKG,8,3,7,18,22,6,28,7507523,22.396428,114.109497
summer,2000,Sydney,Australia,Hungary,HUN,4,5,14,23,41,13,54,9655983,47.162494,19.503304
summer,2000,Sydney,Australia,Iceland,ISL,2,0,2,4,5,1,6,341628,64.963051,-19.020835
summer,2000,Sydney,Australia,India,IND,0,0,0,0,4,0,4,1382345085,20.593684,78.96288
summer,2000,Sydney,Australia,Indonesia,INA,0,0,0,0,4,0,4,274021604,-0.789275,113.921327
summer,2000,Sydney,Australia,Iran,IRI,12,4,7,23,36,4,40,84176929,32.427908,53.688046
summer,2000,Sydney,Australia,Iraq,IRQ,0,0,0,0,3,0,3,40372771,33.223191,43.679291
summer,2000,Sydney,Australia,Ireland,IRL,5,3,1,9,23,15,38,4947267,53.41291,-8.24389
summer,2000,Sydney,Australia,Israel,ISR,3,2,1,6,31,2,33,8678517,31.046051,34.851612
summer,2000,Sydney,Australia,Italy,ITA,9,8,10,27,50,16,66,60446035,41.87194,12.56738
summer,2000,Sydney,Australia,Jamaica,JAM,0,0,0,0,3,2,5,2963429,18.109581,-77.297508
summer,2000,Sydney,Australia,Japan,JPN,13,17,11,41,111,40,151,126407422,36.204824,138.252924
summer,2000,Sydney,Australia,Jordan,JOR,1,0,0,1,5,2,7,10220604,30.585164,36.238414
summer,2000,Sydney,Australia,Kazakhstan,KAZ,0,0,0,0,2,0,2,18815231,48.019573,66.923684
summer,2000,Sydney,Australia,Kenya,KEN,1,1,2,4,8,5,13,53968739,-0.023559,37.906193
summer,2000,Sydney,Australia,South Korea,KOR,18,7,7,32,82,7,89,51276977,35.907757,127.766922
summer,2000,Sydney,Australia,Kuwait,KUW,0,1,4,5,22,4,26,4281320,29.31166,47.481766
summer,2000,Sydney,Australia,Kyrgyzstan,KGZ,0,0,0,0,2,0,2,6542426,41.20438,74.766098
summer,2000,Sydney,Australia,Laos,LAO,0,0,0,0,1,1,2,7293542,19.85627,102.495496
summer,2000,Sydney,Australia,Latvia,LAT,0,0,3,3,4,1,5,1882408,56.879635,24.603189
summer,2000,Sydney,Australia,Lebanon,LBN,0,0,0,0,2,0,2,6819976,33.854721,35.862285
summer,2000,Sydney,Australia,Lesotho,LES,0,0,0,0,1,1,2,2145194,-29.609988,28.233608
summer,2000,Sydney,Australia,Libya,LBA,0,0,1,1,16,1,17,6887247,26.3351,17.228331
summer,2000,Sydney,Australia,Lithuania,LTU,0,2,1,3,14,3,17,2715340,55.169438,23.881275
summer,2000,Sydney,Australia,"Macao, China",MAC,0,0,0,0,1,1,2,650846,22.210928,113.552971
summer,2000,Sydney,Australia,Madagascar,MAD,0,0,0,0,1,0,1,27808395,-18.766947,46.869107
summer,2000,Sydney,Australia,Malaysia,MAS,0,0,0,0,8,2,10,32436963,4.210484,101.975766
summer,2000,Sydney,Australia,Mali,MLI,0,0,0,0,1,0,1,20346106,17.570692,-3.996166
summer,2000,Sydney,Australia,Mauritania,MTN,0,0,0,0,1,1,2,4669775,21.00789,-10.940835
summer,2000,Sydney,Australia,Mexico,MEX,10,12,12,34,48,29,77,129166028,23.634501,-102.552784
summer,2000,Sydney,Australia,Moldova,MDA,0,0,0,0,6,0,6,4032294,47.411631,28.369885
summer,2000,Sydney,Australia,Mongolia,MGL,0,0,0,0,2,0,2,3287242,46.862496,103.846656
summer,2000,Sydney,Australia,Morocco,MAR,0,0,0,0,5,2,7,36985624,31.791702,-7.09262
summer,2000,Sydney,Australia,Netherlands,NED,12,9,9,30,68,33,101,17141544,52.132633,5.291266
summer,2000,Sydney,Australia,New Zealand,NZL,6,8,4,18,36,6,42,4829021,-40.900557,174.885971
summer,2000,Sydney,Australia,Nigeria,NGR,7,1,5,13,18,11,29,206984347,9.081999,8.675277
summer,2000,Sydney,Australia,North Macedonia,MKD,0,0,0,0,2,0,2,2083359,41.608635,21.745275
summer,2000,Sydney,Australia,Norway,NOR,2,6,7,15,26,13,39,5428594,60.472024,8.468946
summer,2000,Sydney,Australia,Oman,OMA,0,0,0,0,3,0,3,5128058,21.512583,55.923255
summer,2000,Sydney,Australia,Pakistan,PAK,0,0,0,0,1,0,1,221612785,30.375321,69.345116
summer,2000,Sydney,Australia,Palestine,PLE,0,0,1,1,1,1,2,5121112,31.952162,35.233154
summer,2000,Sydney,Australia,Panama,PAN,0,1,1,2,1,0,1,4326296,8.537981,-80.782127
summer,2000,Sydney,Australia,Papua New Guinea,PNG,0,0,0,0,3,0,3,8975531,-6.314993,143.95555
summer,2000,Sydney,Australia,Peru,PER,1,1,0,2,3,1,4,33050211,-9.189967,-75.015152
summer,2000,Sydney,Australia,Philippines,PHI,0,0,1,1,1,1,2,109830324,12.879721,121.774017
summer,2000,Sydney,Australia,Poland,POL,19,22,12,53,86,27,113,37839255,51.919438,19.145136
summer,2000,Sydney,Australia,Portugal,POR,6,5,4,15,45,7,52,10191409,39.399872,-8.224454
summer,2000,Sydney,Australia,Puerto Rico,PUR,0,0,1,1,1,2,3,2846860,18.220833,-66.590149
summer,2000,Sydney,Australia,Qatar,QAT,0,0,0,0,3,0,3,2889284,25.354826,51.183884
summer,2000,Sydney,Australia,Romania,ROU,0,0,0,0,1,0,1,19214608,45.943161,24.96676
summer,2000,Sydney,Australia,Russia,RUS,12,11,12,35,69,20,89,145945524,61.52401,105.318756
summer,2000,Sydney,Australia,Rwanda,RWA,0,0,0,0,1,0,1,13005303,-1.940278,29.873888
summer,2000,Sydney,Australia,Samoa,SAM,0,0,0,0,1,0,1,198643,-13.759029,-172.104629
summer,2000,Sydney,Australia,Saudi Arabia,KSA,0,0,0,0,4,0,4,34905942,23.885942,45.079162
summer,2000,Sydney,Australia,Singapore,SGP,0,0,0,0,1,2,3,5858322,1.352083,103.819836
summer,2000,Sydney,Australia,Slovakia,SVK,3,5,5,13,34,11,45,5460109,48.669026,19.699024
summer,2000,Sydney,Australia,Slovenia,SLO,0,2,2,4,15,2,17,2078989,46.151241,14.995463
summer,2000,Sydney,Australia,South Africa,RSA,13,12,13,38,50,16,66,59436725,-30.559482,22.937506
summer,2000,Sydney,Australia,Spain,ESP,38,30,38,106,157,52,209,46757980,40.463667,-3.74922
summer,2000,Sydney,Australia,Sri Lanka,SRI,0,0,0,0,3,0,3,21428970,7.873054,80.771797
summer,2000,Sydney,Australia,Sweden,SWE,5,6,10,21,70,17,87,10110233,60.128161,18.643501
summer,2000,Sydney,Australia,Switzerland,SUI,8,4,8,20,44,9,53,8665615,46.818188,8.227512
summer,2000,Sydney,Australia,Syrian,SYR,0,0,0,0,3,1,4,17500658,34.8149,39.0465
summer,2000,Sydney,Australia,Thailand,THA,5,4,2,11,35,6,41,69830779,15.870032,100.992541
summer,2000,Sydney,Australia,Tonga,TGA,0,0,0,0,0,1,1,105901,-21.178986,-175.198242
summer,2000,Sydney,Australia,Tunisia,TUN,6,4,1,11,8,2,10,11839918,33.886917,9.537499
summer,2000,Sydney,Australia,Turkey,TUR,0,0,0,0,1,0,1,84495243,38.963745,35.243322
summer,2000,Sydney,Australia,Turkmenistan,TKM,0,0,0,0,1,0,1,6046292,38.969719,59.556278
summer,2000,Sydney,Australia,Uganda,UGA,0,0,0,0,0,1,1,45974931,1.373333,32.290275
summer,2000,Sydney,Australia,Ukraine,UKR,3,20,14,37,49,18,67,43686577,48.379433,31.16558
summer,2000,Sydney,Australia,United Arab Emirates,UAE,0,3,1,4,14,0,14,9910892,23.424076,53.847818
summer,2000,Sydney,Australia,United States of America ,USA,36,39,34,109,181,86,267,#N/A,#N/A,#N/A
summer,2000,Sydney,Australia,Uruguay,URU,0,0,0,0,1,1,2,3475842,-32.522779,-55.765835
summer,2000,Sydney,Australia,Vanuatu,VAN,0,0,0,0,1,1,2,308337,-15.376706,166.959158
summer,2000,Sydney,Australia,Venezuela,VEN,0,0,1,1,8,2,10,28421581,6.42375,-66.58973
summer,2000,Sydney,Australia,Vietnam,VIE,0,0,0,0,1,1,2,97490013,14.058324,108.277199
summer,2000,Sydney,Australia,Yugoslavia,YUG,0,1,0,1,2,0,2,23528230,14.48329,121.02138
summer,2000,Sydney,Australia,Zambia,ZAM,0,0,0,0,1,1,2,18468257,-13.133897,27.849332
summer,2000,Sydney,Australia,Zimbabwe,ZIM,1,0,0,1,2,1,3,14899771,-19.015438,29.154857
summer,2004,Athens,Greece,Afghanistan,AFG,0,0,0,0,1,2,3,39074280,33.93911,67.709953
summer,2004,Athens,Greece,Algeria,ALG,6,2,5,13,14,4,18,43984569,28.033886,1.659626
summer,2004,Athens,Greece,Angola,ANG,3,0,0,3,3,1,4,33032075,-11.202692,17.873887
summer,2004,Athens,Greece,Argentina,ARG,0,2,2,4,42,11,53,45267449,-38.416097,-63.616672
summer,2004,Athens,Greece,Armenia,ARM,0,0,0,0,1,1,2,2964219,40.069099,45.038189
summer,2004,Athens,Greece,Australia,AUS,26,39,36,101,89,56,145,25550683,-25.274398,133.775136
summer,2004,Athens,Greece,Austria,AUT,8,10,4,22,40,4,44,9015361,47.516231,14.550072
summer,2004,Athens,Greece,Azerbaijan,AZE,2,1,1,4,8,1,9,10154978,40.143105,47.576927
summer,2004,Athens,Greece,Bahrain,BRN,0,1,0,1,5,0,5,1711057,25.930414,50.637772
summer,2004,Athens,Greece,Bangladesh,BAN,0,0,0,0,1,0,1,164972348,23.684994,90.356331
summer,2004,Athens,Greece,Barbados,BAR,0,0,0,0,1,0,1,287437,13.193887,-59.543198
summer,2004,Athens,Greece,Belarus,BLR,10,12,7,29,19,11,30,9448772,53.709807,27.953389
summer,2004,Athens,Greece,Belgium,BEL,3,2,2,7,24,1,25,11598451,50.503887,4.469936
summer,2004,Athens,Greece,Benin,BEN,0,0,0,0,1,1,2,12175480,9.30769,2.315834
summer,2004,Athens,Greece,Bermuda,BER,0,0,0,0,0,2,2,62237,32.321384,-64.75737
summer,2004,Athens,Greece,Bosnia and Herzegovina,BIH,1,0,0,1,15,0,15,3277152,43.915886,17.679076
summer,2004,Athens,Greece,Botswana,BOT,1,0,0,1,0,1,1,2359585,-22.328474,24.684866
summer,2004,Athens,Greece,Brazil,BRA,14,12,7,33,72,22,94,212821986,-14.235004,-51.92528
summer,2004,Athens,Greece,Bulgaria,BUL,0,0,0,0,6,3,9,6939018,42.733883,25.48583
summer,2004,Athens,Greece,Cambodia,CAM,0,0,0,0,1,1,2,16758448,12.565679,104.990963
summer,2004,Athens,Greece,Canada,CAN,28,19,25,72,89,53,142,37799407,56.130366,-106.346771
summer,2004,Athens,Greece,Cape Verde,CPV,0,0,0,0,2,1,3,549935,16.002082,-24.013197
summer,2004,Athens,Greece,Central African Republic,CAF,0,0,0,0,1,0,1,4843954,6.611111,20.939444
summer,2004,Athens,Greece,Chile,CHI,0,0,0,0,4,0,4,19144605,-35.675147,-71.542969
summer,2004,Athens,Greece,United States of America ,CHN,63,46,32,141,108,89,197,#N/A,#N/A,#N/A
summer,2004,Athens,Greece,Chinese Taipei,TPE,2,2,2,6,15,10,25,23816775,25.105497,121.597366
summer,2004,Athens,Greece,Colombia,COL,0,0,0,0,4,1,5,50976248,4.570868,-74.297333
summer,2004,Athens,Greece,Costa Rica,CRC,0,0,0,0,1,0,1,5102158,9.748917,-83.753428
summer,2004,Athens,Greece,Côte d'Ivoire,CIV,0,0,0,0,2,0,2,26486282,7.539989,-5.54708
summer,2004,Athens,Greece,Croatia,CRO,0,0,4,4,12,5,17,4100719,45.1,15.2
summer,2004,Athens,Greece,Cuba,CUB,2,2,7,11,19,5,24,11325391,21.521757,-77.781167
summer,2004,Athens,Greece,Cyprus,CYP,1,0,0,1,2,3,5,1208886,35.126413,33.429859
summer,2004,Athens,Greece,Czech Republic,CZE,16,8,7,31,45,20,65,10712481,49.817492,15.472962
summer,2004,Athens,Greece,Denmark,DEN,5,3,7,15,22,10,32,5795780,56.26392,9.501785
summer,2004,Athens,Greece,Dominican Republic,DOM,0,0,0,0,1,1,2,10866667,18.735693,-70.162651
summer,2004,Athens,Greece,Ecuador,ECU,0,0,0,0,3,1,4,17688599,-1.831239,-78.183406
summer,2004,Athens,Greece,Egypt,EGY,6,9,8,23,36,10,46,102659126,26.820553,30.802498
summer,2004,Athens,Greece,El Salvador,ESA,0,0,0,0,1,1,2,6491923,13.794185,-88.89653
summer,2004,Athens,Greece,Estonia,EST,0,1,0,1,4,2,6,1326693,58.595272,25.013607
summer,2004,Athens,Greece,Ethiopia,ETH,0,0,0,0,1,0,1,115434444,9.145,40.489673
summer,2004,Athens,Greece,Faroe Islands,FRO,0,0,1,1,0,1,1,48678,61.892635,-6.911806
summer,2004,Athens,Greece,Fiji,FIJ,0,0,0,0,1,1,2,897573,-16.578193,179.414413
summer,2004,Athens,Greece,Finland,FIN,4,1,3,8,31,23,54,5542237,61.92411,25.748151
summer,2004,Athens,Greece,France,FRA,18,26,30,74,102,30,132,65298930,46.227638,2.213749
summer,2004,Athens,Greece,Germany,GER,19,28,31,78,138,70,208,83830972,51.165691,10.451526
summer,2004,Athens,Greece,Ghana,GHA,0,0,0,0,2,1,3,31181428,7.946527,-1.023194
summer,2004,Athens,Greece,Great Britain,GBR,35,30,29,94,99,65,164,67948282,55.378051,-3.435973
summer,2004,Athens,Greece,Greece,GRE,3,13,4,20,104,17,121,10413936,39.074208,21.824312
summer,2004,Athens,Greece,Guatemala,GUA,0,0,0,0,1,1,2,17971382,15.783471,-90.230759
summer,2004,Athens,Greece,Guinea,GUY,0,0,0,0,1,0,1,13191279,9.945587,-9.696645
summer,2004,Athens,Greece,Honduras,HON,0,0,0,0,1,1,2,9931333,15.199999,-86.241905
summer,2004,Athens,Greece,"Hong Kong, China",HKG,11,7,1,19,15,9,24,7507523,22.396428,114.109497
summer,2004,Athens,Greece,Hungary,HUN,1,8,10,19,25,12,37,9655983,47.162494,19.503304
summer,2004,Athens,Greece,Iceland,ISL,1,3,0,4,2,1,3,341628,64.963051,-19.020835
summer,2004,Athens,Greece,India,IND,1,0,1,2,11,1,12,1382345085,20.593684,78.96288
summer,2004,Athens,Greece,Indonesia,INA,0,0,0,0,3,0,3,274021604,-0.789275,113.921327
summer,2004,Athens,Greece,Iran,IRI,6,3,13,22,83,6,89,84176929,32.427908,53.688046
summer,2004,Athens,Greece,Iraq,IRQ,1,0,1,2,8,0,8,40372771,33.223191,43.679291
summer,2004,Athens,Greece,Ireland,IRL,0,3,1,4,32,8,40,4947267,53.41291,-8.24389
summer,2004,Athens,Greece,Israel,ISR,4,4,5,13,21,3,24,8678517,31.046051,34.851612
summer,2004,Athens,Greece,Italy,ITA,4,8,7,19,61,14,75,60446035,41.87194,12.56738
summer,2004,Athens,Greece,Jamaica,JAM,1,0,1,2,2,2,4,2963429,18.109581,-77.297508
summer,2004,Athens,Greece,Japan,JPN,17,15,20,52,106,54,160,126407422,36.204824,138.252924
summer,2004,Athens,Greece,Jordan,JOR,0,1,1,2,5,5,10,10220604,30.585164,36.238414
summer,2004,Athens,Greece,Kazakhstan,KAZ,0,0,0,0,6,2,8,18815231,48.019573,66.923684
summer,2004,Athens,Greece,Kenya,KEN,3,1,3,7,8,8,16,53968739,-0.023559,37.906193
summer,2004,Athens,Greece,South Korea,KOR,11,11,6,28,70,10,80,51276977,35.907757,127.766922
summer,2004,Athens,Greece,Kuwait,KUW,1,2,3,6,13,1,14,4281320,29.31166,47.481766
summer,2004,Athens,Greece,Kyrgyzstan,KGZ,0,0,0,0,3,0,3,6542426,41.20438,74.766098
summer,2004,Athens,Greece,Latvia,LAT,1,1,1,3,3,4,7,1882408,56.879635,24.603189
summer,2004,Athens,Greece,Lesotho,LES,0,0,0,0,1,1,2,2145194,-29.609988,28.233608
summer,2004,Athens,Greece,Libya,LBA,0,0,0,0,1,1,2,6887247,26.3351,17.228331
summer,2004,Athens,Greece,Liechtenstein,LIE,0,0,0,0,1,0,1,38147,47.166,9.555373
summer,2004,Athens,Greece,Lithuania,LTU,1,1,5,7,16,4,20,2715340,55.169438,23.881275
summer,2004,Athens,Greece,"Macao, China",MAC,0,0,0,0,1,0,1,650846,22.210928,113.552971
summer,2004,Athens,Greece,Malaysia,MAS,0,0,0,0,15,4,19,32436963,4.210484,101.975766
summer,2004,Athens,Greece,Mauritania,MTN,0,0,0,0,0,1,1,4669775,21.00789,-10.940835
summer,2004,Athens,Greece,Mauritius,MRI,0,0,0,0,1,1,2,1272140,-20.348404,57.552152
summer,2004,Athens,Greece,Mexico,MEX,14,10,10,34,36,41,77,129166028,23.634501,-102.552784
summer,2004,Athens,Greece,Moldova,MDA,0,0,0,0,3,0,3,4032294,47.411631,28.369885
summer,2004,Athens,Greece,Mongolia,MGL,0,0,0,0,2,1,3,3287242,46.862496,103.846656
summer,2004,Athens,Greece,Morocco,MAR,2,4,0,6,7,3,10,36985624,31.791702,-7.09262
summer,2004,Athens,Greece,Namibia,NAM,0,0,0,0,1,0,1,2548663,-22.95764,18.49041
summer,2004,Athens,Greece,Nepal,NEP,0,0,0,0,0,1,1,29225196,28.394857,84.124008
summer,2004,Athens,Greece,Netherlands,NED,5,12,12,29,51,42,93,17141544,52.132633,5.291266
summer,2004,Athens,Greece,New Zealand,NZL,6,1,3,10,28,8,36,4829021,-40.900557,174.885971
summer,2004,Athens,Greece,Nicaragua,NCA,0,0,0,0,1,0,1,6638075,12.865416,-85.207229
summer,2004,Athens,Greece,Niger,NIG,0,0,0,0,1,0,1,24346468,17.607789,8.081666
summer,2004,Athens,Greece,Nigeria,NGR,5,4,3,12,6,8,14,206984347,9.081999,8.675277
summer,2004,Athens,Greece,North Macedonia,MKD,0,1,0,1,2,1,3,2083359,41.608635,21.745275
summer,2004,Athens,Greece,Norway,NOR,3,1,1,5,19,11,30,5428594,60.472024,8.468946
summer,2004,Athens,Greece,Oman,OMA,0,0,0,0,2,0,2,5128058,21.512583,55.923255
summer,2004,Athens,Greece,Pakistan,PAK,0,0,0,0,8,1,9,221612785,30.375321,69.345116
summer,2004,Athens,Greece,Palestine,PLE,0,1,1,2,2,0,2,5121112,31.952162,35.233154
summer,2004,Athens,Greece,Panama,PAN,0,1,0,1,1,1,2,4326296,8.537981,-80.782127
summer,2004,Athens,Greece,Peru,PER,0,0,2,2,4,1,5,33050211,-9.189967,-75.015152
summer,2004,Athens,Greece,Philippines,PHI,0,0,0,0,1,1,2,109830324,12.879721,121.774017
summer,2004,Athens,Greece,Poland,POL,10,25,19,54,68,34,102,37839255,51.919438,19.145136
summer,2004,Athens,Greece,Portugal,POR,2,5,5,12,22,7,29,10191409,39.399872,-8.224454
summer,2004,Athens,Greece,Puerto Rico,PUR,0,0,1,1,1,1,2,2846860,18.220833,-66.590149
summer,2004,Athens,Greece,Qatar,QAT,0,0,0,0,2,0,2,2889284,25.354826,51.183884
summer,2004,Athens,Greece,Romania,ROU,0,0,0,0,2,0,2,19214608,45.943161,24.96676
summer,2004,Athens,Greece,Russia,RUS,16,8,17,41,49,35,84,145945524,61.52401,105.318756
summer,2004,Athens,Greece,Rwanda,RWA,0,0,1,1,1,1,2,13005303,-1.940278,29.873888
summer,2004,Athens,Greece,Samoa,SAM,0,0,0,0,1,1,2,198643,-13.759029,-172.104629
summer,2004,Athens,Greece,Saudi Arabia,KSA,0,0,0,0,6,0,6,34905942,23.885942,45.079162
summer,2004,Athens,Greece,Senegal,SEN,0,0,0,0,1,1,2,16816539,14.497401,-14.452362
summer,2004,Athens,Greece,Singapore,SGP,0,0,0,0,4,3,7,5858322,1.352083,103.819836
summer,2004,Athens,Greece,Slovakia,SVK,5,3,4,12,28,8,36,5460109,48.669026,19.699024
summer,2004,Athens,Greece,Slovenia,SLO,1,2,1,4,14,14,28,2078989,46.151241,14.995463
summer,2004,Athens,Greece,South Africa,RSA,15,13,7,35,31,20,51,59436725,-30.559482,22.937506
summer,2004,Athens,Greece,Spain,ESP,20,27,24,71,118,34,152,46757980,40.463667,-3.74922
summer,2004,Athens,Greece,Sri Lanka,SRI,0,0,0,0,6,0,6,21428970,7.873054,80.771797
summer,2004,Athens,Greece,Sudan,SUD,0,0,0,0,1,1,2,44019263,12.862807,30.217636
summer,2004,Athens,Greece,Suriname,SUR,0,0,0,0,1,1,2,587541,3.919305,-56.027783
summer,2004,Athens,Greece,Sweden,SWE,8,7,6,21,32,9,41,10110233,60.128161,18.643501
summer,2004,Athens,Greece,Switzerland,SUI,2,6,8,16,26,14,40,8665615,46.818188,8.227512
summer,2004,Athens,Greece,Syrian,SYR,0,0,0,0,3,2,5,17500658,34.8149,39.0465
summer,2004,Athens,Greece,Tajikistan,TJK,0,0,0,0,1,0,1,9573310,38.861034,71.276093
summer,2004,Athens,Greece,United Republic of the Tanzania,TAN,0,0,0,0,1,1,2,#N/A,#N/A,#N/A
summer,2004,Athens,Greece,Thailand,THA,3,6,6,15,33,10,43,69830779,15.870032,100.992541
summer,2004,Athens,Greece,Tonga,TGA,0,0,0,0,0,1,1,105901,-21.178986,-175.198242
summer,2004,Athens,Greece,Tunisia,TUN,8,7,3,18,14,8,22,11839918,33.886917,9.537499
summer,2004,Athens,Greece,Turkey,TUR,1,0,1,2,8,1,9,84495243,38.963745,35.243322
summer,2004,Athens,Greece,Turkmenistan,TKM,0,0,0,0,4,0,4,6046292,38.969719,59.556278
summer,2004,Athens,Greece,Uganda,UGA,0,0,0,0,1,1,2,45974931,1.373333,32.290275
summer,2004,Athens,Greece,Ukraine,UKR,24,12,19,55,57,31,88,43686577,48.379433,31.16558
summer,2004,Athens,Greece,United Arab Emirates,UAE,1,1,2,4,10,0,10,9910892,23.424076,53.847818
summer,2004,Athens,Greece,United States of America ,USA,27,22,39,88,147,87,234,#N/A,#N/A,#N/A
summer,2004,Athens,Greece,Uruguay,URU,0,0,0,0,3,0,3,3475842,-32.522779,-55.765835
summer,2004,Athens,Greece,Uzbekistan,UZB,0,0,0,0,1,0,1,33551824,41.377491,64.585262
summer,2004,Athens,Greece,Venezuela,VEN,0,1,2,3,14,2,16,28421581,6.42375,-66.58973
summer,2004,Athens,Greece,Vietnam,VIE,0,0,0,0,0,4,4,97490013,14.058324,108.277199
summer,2004,Athens,Greece,Zimbabwe,ZIM,1,0,0,1,1,1,2,14899771,-19.015438,29.154857
summer,2008,Beijing,China,Afghanistan,AFG,0,0,0,0,1,0,1,39074280,33.93911,67.709953
summer,2008,Beijing,China,Algeria,ALG,4,3,8,15,21,7,28,43984569,28.033886,1.659626
summer,2008,Beijing,China,Angola,ANG,0,3,0,3,5,1,6,33032075,-11.202692,17.873887
summer,2008,Beijing,China,Argentina,ARG,0,1,5,6,30,9,39,45267449,-38.416097,-63.616672
summer,2008,Beijing,China,Armenia,ARM,0,0,0,0,0,1,1,2964219,40.069099,45.038189
summer,2008,Beijing,China,Australia,AUS,23,29,27,79,86,70,156,25550683,-25.274398,133.775136
summer,2008,Beijing,China,Austria,AUT,4,1,1,6,34,4,38,9015361,47.516231,14.550072
summer,2008,Beijing,China,Azerbaijan,AZE,2,3,5,10,17,1,18,10154978,40.143105,47.576927
summer,2008,Beijing,China,Bahrain,BRN,0,0,0,0,2,1,3,1711057,25.930414,50.637772
summer,2008,Beijing,China,Bangladesh,BAN,0,0,0,0,1,0,1,164972348,23.684994,90.356331
summer,2008,Beijing,China,Barbados,BAR,0,0,0,0,1,0,1,287437,13.193887,-59.543198
summer,2008,Beijing,China,Belarus,BLR,5,7,1,13,19,11,30,9448772,53.709807,27.953389
summer,2008,Beijing,China,Belgium,BEL,0,0,1,1,19,1,20,11598451,50.503887,4.469936
summer,2008,Beijing,China,Benin,BEN,0,0,0,0,0,1,1,12175480,9.30769,2.315834
summer,2008,Beijing,China,Bermuda,BER,0,0,0,0,1,0,1,62237,32.321384,-64.75737
summer,2008,Beijing,China,Bosnia and Herzegovina,BIH,0,1,0,1,14,1,15,3277152,43.915886,17.679076
summer,2008,Beijing,China,Brazil,BRA,16,14,17,47,130,54,184,212821986,-14.235004,-51.92528
summer,2008,Beijing,China,Bulgaria,BUL,0,1,1,2,4,4,8,6939018,42.733883,25.48583
summer,2008,Beijing,China,Burkina Faso,BUR,0,0,0,0,1,0,1,20997293,12.238333,-1.561593
summer,2008,Beijing,China,Burundi,BDI,0,0,0,0,3,0,3,11948454,-3.373056,29.918886
summer,2008,Beijing,China,Cambodia,CAM,0,0,0,0,1,0,1,16758448,12.565679,104.990963
summer,2008,Beijing,China,Canada,CAN,19,10,21,50,80,61,141,37799407,56.130366,-106.346771
summer,2008,Beijing,China,Cape Verde,CPV,0,0,0,0,0,1,1,549935,16.002082,-24.013197
summer,2008,Beijing,China,Central African Republic,CAF,0,0,0,0,1,0,1,4843954,6.611111,20.939444
summer,2008,Beijing,China,Chile,CHI,0,0,0,0,3,1,4,19144605,-35.675147,-71.542969
summer,2008,Beijing,China,United States of America ,CHN,89,70,52,211,196,135,331,#N/A,#N/A,#N/A
summer,2008,Beijing,China,Chinese Taipei,TPE,1,0,1,2,10,7,17,23816775,25.105497,121.597366
summer,2008,Beijing,China,Colombia,COL,0,1,1,2,9,2,11,50976248,4.570868,-74.297333
summer,2008,Beijing,China,Costa Rica,CRC,0,0,0,0,2,0,2,5102158,9.748917,-83.753428
summer,2008,Beijing,China,Côte d'Ivoire,CIV,0,0,0,0,3,0,3,26486282,7.539989,-5.54708
summer,2008,Beijing,China,Croatia,CRO,3,1,0,4,19,6,25,4100719,45.1,15.2
summer,2008,Beijing,China,Cuba,CUB,5,3,6,14,26,5,31,11325391,21.521757,-77.781167
summer,2008,Beijing,China,Cyprus,CYP,1,2,1,4,3,1,4,1208886,35.126413,33.429859
summer,2008,Beijing,China,Czech Republic,CZE,6,3,18,27,37,19,56,10712481,49.817492,15.472962
summer,2008,Beijing,China,Denmark,DEN,3,2,4,9,22,15,37,5795780,56.26392,9.501785
summer,2008,Beijing,China,Dominican Republic,DOM,0,0,0,0,1,0,1,10866667,18.735693,-70.162651
summer,2008,Beijing,China,Ecuador,ECU,0,0,0,0,1,1,2,17688599,-1.831239,-78.183406
summer,2008,Beijing,China,Egypt,EGY,4,4,4,12,27,9,36,102659126,26.820553,30.802498
summer,2008,Beijing,China,El Salvador,ESA,0,0,0,0,0,1,1,6491923,13.794185,-88.89653
summer,2008,Beijing,China,Estonia,EST,0,0,1,1,3,0,3,1326693,58.595272,25.013607
summer,2008,Beijing,China,Ethiopia,ETH,0,0,0,0,2,0,2,115434444,9.145,40.489673
summer,2008,Beijing,China,Faroe Islands,FRO,0,0,0,0,0,1,1,48678,61.892635,-6.911806
summer,2008,Beijing,China,Fiji,FIJ,0,0,0,0,1,0,1,897573,-16.578193,179.414413
summer,2008,Beijing,China,Finland,FIN,2,2,2,6,25,6,31,5542237,61.92411,25.748151
summer,2008,Beijing,China,France,FRA,12,21,19,52,80,39,119,65298930,46.227638,2.213749
summer,2008,Beijing,China,Gabon,GAB,0,0,0,0,1,0,1,2234448,-0.803689,11.609444
summer,2008,Beijing,China,Georgia,GEO,0,0,0,0,1,0,1,3987805,42.315407,43.356892
summer,2008,Beijing,China,Germany,GER,14,25,20,59,104,66,170,83830972,51.165691,10.451526
summer,2008,Beijing,China,Ghana,GHA,0,0,0,0,1,1,2,31181428,7.946527,-1.023194
summer,2008,Beijing,China,Great Britain,GBR,42,29,31,102,130,75,205,67948282,55.378051,-3.435973
summer,2008,Beijing,China,Greece,GRE,5,9,10,24,52,15,67,10413936,39.074208,21.824312
summer,2008,Beijing,China,Guatemala,GUA,0,0,0,0,1,0,1,17971382,15.783471,-90.230759
summer,2008,Beijing,China,Guinea,GUY,0,0,0,0,1,0,1,13191279,9.945587,-9.696645
summer,2008,Beijing,China,Haiti,HAI,0,0,0,0,0,1,1,11426356,18.971187,-72.285215
summer,2008,Beijing,China,Honduras,HON,0,0,0,0,1,0,1,9931333,15.199999,-86.241905
summer,2008,Beijing,China,"Hong Kong, China",HKG,5,3,3,11,10,12,22,7507523,22.396428,114.109497
summer,2008,Beijing,China,Hungary,HUN,1,0,5,6,23,10,33,9655983,47.162494,19.503304
summer,2008,Beijing,China,Iceland,ISL,0,0,0,0,4,1,5,341628,64.963051,-19.020835
summer,2008,Beijing,China,India,IND,0,0,0,0,5,0,5,1382345085,20.593684,78.96288
summer,2008,Beijing,China,Indonesia,INA,0,0,0,0,2,1,3,274021604,-0.789275,113.921327
summer,2008,Beijing,China,Iran,IRI,5,6,3,14,68,4,72,84176929,32.427908,53.688046
summer,2008,Beijing,China,Iraq,IRQ,0,1,1,2,17,2,19,40372771,33.223191,43.679291
summer,2008,Beijing,China,Ireland,IRL,3,1,1,5,33,12,45,4947267,53.41291,-8.24389
summer,2008,Beijing,China,Israel,ISR,0,5,1,6,34,8,42,8678517,31.046051,34.851612
summer,2008,Beijing,China,Italy,ITA,4,7,7,18,55,27,82,60446035,41.87194,12.56738
summer,2008,Beijing,China,Jamaica,JAM,0,0,1,1,2,2,4,2963429,18.109581,-77.297508
summer,2008,Beijing,China,Japan,JPN,5,14,8,27,97,64,161,126407422,36.204824,138.252924
summer,2008,Beijing,China,Jordan,JOR,0,2,2,4,7,5,12,10220604,30.585164,36.238414
summer,2008,Beijing,China,Kazakhstan,KAZ,0,0,0,0,1,2,3,18815231,48.019573,66.923684
summer,2008,Beijing,China,Kenya,KEN,5,3,1,9,10,3,13,53968739,-0.023559,37.906193
summer,2008,Beijing,China,South Korea,KOR,10,8,13,31,57,20,77,51276977,35.907757,127.766922
summer,2008,Beijing,China,Kuwait,KUW,0,0,0,0,7,1,8,4281320,29.31166,47.481766
summer,2008,Beijing,China,Kyrgyzstan,KGZ,0,0,0,0,1,0,1,6542426,41.20438,74.766098
summer,2008,Beijing,China,Laos,LAO,0,0,1,1,1,0,1,7293542,19.85627,102.495496
summer,2008,Beijing,China,Latvia,LAT,1,2,0,3,4,13,17,1882408,56.879635,24.603189
summer,2008,Beijing,China,Lebanon,LBN,0,0,2,2,1,0,1,6819976,33.854721,35.862285
summer,2008,Beijing,China,Lesotho,LES,0,0,0,0,0,1,1,2145194,-29.609988,28.233608
summer,2008,Beijing,China,Libya,LBA,0,0,0,0,2,1,3,6887247,26.3351,17.228331
summer,2008,Beijing,China,Lithuania,LTU,0,2,0,2,12,14,26,2715340,55.169438,23.881275
summer,2008,Beijing,China,Luxembourg,LUX,0,0,0,0,1,0,1,627704,49.815273,6.129583
summer,2008,Beijing,China,"Macao, China",MAC,0,0,0,0,1,1,2,650846,22.210928,113.552971
summer,2008,Beijing,China,Madagascar,MAD,0,0,0,0,1,0,1,27808395,-18.766947,46.869107
summer,2008,Beijing,China,Malaysia,MAS,0,0,1,1,8,3,11,32436963,4.210484,101.975766
summer,2008,Beijing,China,Malta,MLT,0,0,0,0,1,0,1,441750,35.937496,14.375416
summer,2008,Beijing,China,Mauritius,MRI,0,0,0,0,2,0,2,1272140,-20.348404,57.552152
summer,2008,Beijing,China,Mexico,MEX,10,3,7,20,30,37,67,129166028,23.634501,-102.552784
summer,2008,Beijing,China,Moldova,MDA,0,0,0,0,0,1,1,4032294,47.411631,28.369885
summer,2008,Beijing,China,Mongolia,MGL,1,0,0,1,1,3,4,3287242,46.862496,103.846656
summer,2008,Beijing,China,Montenegro,MNE,0,0,0,0,1,0,1,628080,42.708678,19.37439
summer,2008,Beijing,China,Morocco,MAR,4,1,2,7,12,6,18,36985624,31.791702,-7.09262
summer,2008,Beijing,China,Myanmar,MYA,0,0,0,0,3,0,3,54473253,21.913965,95.956223
summer,2008,Beijing,China,Namibia,NAM,0,0,1,1,1,0,1,2548663,-22.95764,18.49041
summer,2008,Beijing,China,Nepal,NEP,0,0,0,0,1,0,1,29225196,28.394857,84.124008
summer,2008,Beijing,China,Netherlands,NED,5,10,7,22,33,46,79,17141544,52.132633,5.291266
summer,2008,Beijing,China,New Zealand,NZL,5,3,4,12,20,9,29,4829021,-40.900557,174.885971
summer,2008,Beijing,China,Niger,NIG,0,0,0,0,1,0,1,24346468,17.607789,8.081666
summer,2008,Beijing,China,Nigeria,NGR,4,4,1,9,14,9,23,206984347,9.081999,8.675277
summer,2008,Beijing,China,North Macedonia,MKD,0,0,0,0,1,1,2,2083359,41.608635,21.745275
summer,2008,Beijing,China,Norway,NOR,1,3,3,7,14,10,24,5428594,60.472024,8.468946
summer,2008,Beijing,China,Oman,OMA,0,0,0,0,1,0,1,5128058,21.512583,55.923255
summer,2008,Beijing,China,Pakistan,PAK,0,1,0,1,2,1,3,221612785,30.375321,69.345116
summer,2008,Beijing,China,Palestine,PLE,0,0,0,0,2,0,2,5121112,31.952162,35.233154
summer,2008,Beijing,China,Panama,PAN,0,0,0,0,1,1,2,4326296,8.537981,-80.782127
summer,2008,Beijing,China,Papua New Guinea,PNG,0,1,0,1,1,1,2,8975531,-6.314993,143.95555
summer,2008,Beijing,China,Peru,PER,0,0,0,0,3,0,3,33050211,-9.189967,-75.015152
summer,2008,Beijing,China,Philippines,PHI,0,0,0,0,1,2,3,109830324,12.879721,121.774017
summer,2008,Beijing,China,Poland,POL,5,12,13,30,58,33,91,37839255,51.919438,19.145136
summer,2008,Beijing,China,Portugal,POR,1,4,2,7,23,12,35,10191409,39.399872,-8.224454
summer,2008,Beijing,China,Puerto Rico,PUR,0,0,1,1,2,1,3,2846860,18.220833,-66.590149
summer,2008,Beijing,China,Qatar,QAT,0,0,0,0,2,0,2,2889284,25.354826,51.183884
summer,2008,Beijing,China,Romania,ROU,0,1,0,1,2,2,4,19214608,45.943161,24.96676
summer,2008,Beijing,China,Russia,RUS,18,23,22,63,98,46,144,145945524,61.52401,105.318756
summer,2008,Beijing,China,Rwanda,RWA,0,0,0,0,1,0,1,13005303,-1.940278,29.873888
summer,2008,Beijing,China,Samoa,SAM,0,0,0,0,1,0,1,198643,-13.759029,-172.104629
summer,2008,Beijing,China,Saudi Arabia,KSA,1,1,0,2,3,0,3,34905942,23.885942,45.079162
summer,2008,Beijing,China,Senegal,SEN,0,0,0,0,1,1,2,16816539,14.497401,-14.452362
summer,2008,Beijing,China,Serbia,SRB,0,2,0,2,10,4,14,8731081,44.016521,21.005859
summer,2008,Beijing,China,Singapore,SGP,1,1,2,4,2,4,6,5858322,1.352083,103.819836
summer,2008,Beijing,China,Slovakia,SVK,2,3,1,6,26,9,35,5460109,48.669026,19.699024
summer,2008,Beijing,China,Slovenia,SLO,0,1,2,3,14,16,30,2078989,46.151241,14.995463
summer,2008,Beijing,China,South Africa,RSA,21,3,6,30,38,21,59,59436725,-30.559482,22.937506
summer,2008,Beijing,China,Spain,ESP,15,21,22,58,101,32,133,46757980,40.463667,-3.74922
summer,2008,Beijing,China,Sri Lanka,SRI,0,0,0,0,5,0,5,21428970,7.873054,80.771797
summer,2008,Beijing,China,Suriname,SUR,0,0,0,0,1,0,1,587541,3.919305,-56.027783
summer,2008,Beijing,China,Sweden,SWE,5,3,4,12,38,25,63,10110233,60.128161,18.643501
summer,2008,Beijing,China,Switzerland,SUI,3,2,6,11,18,8,26,8665615,46.818188,8.227512
summer,2008,Beijing,China,Syrian,SYR,0,0,1,1,3,2,5,17500658,34.8149,39.0465
summer,2008,Beijing,China,Tajikistan,TJK,0,0,0,0,0,1,1,9573310,38.861034,71.276093
summer,2008,Beijing,China,United Republic of the Tanzania,TAN,0,0,0,0,1,0,1,#N/A,#N/A,#N/A
summer,2008,Beijing,China,Thailand,THA,1,5,7,13,33,7,40,69830779,15.870032,100.992541
summer,2008,Beijing,China,Timor-Leste,TLS,0,0,0,0,0,1,1,1322667,-8.874217,125.727539
summer,2008,Beijing,China,Tonga,TGA,0,0,0,0,1,0,1,105901,-21.178986,-175.198242
summer,2008,Beijing,China,Tunisia,TUN,9,9,3,21,21,12,33,11839918,33.886917,9.537499
summer,2008,Beijing,China,Turkey,TUR,1,0,1,2,8,8,16,84495243,38.963745,35.243322
summer,2008,Beijing,China,Turkmenistan,TKM,0,0,0,0,1,2,3,6046292,38.969719,59.556278
summer,2008,Beijing,China,Uganda,UGA,0,0,0,0,1,0,1,45974931,1.373333,32.290275
summer,2008,Beijing,China,Ukraine,UKR,24,18,32,74,74,49,123,43686577,48.379433,31.16558
summer,2008,Beijing,China,United Arab Emirates,UAE,0,1,0,1,6,1,7,9910892,23.424076,53.847818
summer,2008,Beijing,China,United States of America ,USA,36,35,28,99,120,87,207,#N/A,#N/A,#N/A
summer,2008,Beijing,China,Uruguay,URU,0,0,0,0,2,0,2,3475842,-32.522779,-55.765835
summer,2008,Beijing,China,Uzbekistan,UZB,0,0,0,0,2,0,2,33551824,41.377491,64.585262
summer,2008,Beijing,China,Vanuatu,VAN,0,0,0,0,1,0,1,308337,-15.376706,166.959158
summer,2008,Beijing,China,Venezuela,VEN,1,1,2,4,19,8,27,28421581,6.42375,-66.58973
summer,2008,Beijing,China,Vietnam,VIE,0,0,0,0,3,5,8,97490013,14.058324,108.277199
summer,2008,Beijing,China,Zambia,ZAM,0,0,0,0,1,0,1,18468257,-13.133897,27.849332
summer,2008,Beijing,China,Zimbabwe,ZIM,0,0,0,0,1,1,2,14899771,-19.015438,29.154857
summer,2012,London,Great Britain,Afghanistan,AFG,0,0,0,0,1,0,1,39074280,33.93911,67.709953
summer,2012,London,Great Britain,Albania,ALB,0,0,0,0,1,0,1,2877239,41.153332,20.168331
summer,2012,London,Great Britain,Algeria,ALG,4,6,9,19,24,7,31,43984569,28.033886,1.659626
summer,2012,London,Great Britain,Andorra,AND,0,0,0,0,1,0,1,77287,42.546245,1.601554
summer,2012,London,Great Britain,Angola,ANG,1,0,1,2,2,2,4,33032075,-11.202692,17.873887
summer,2012,London,Great Britain,Antigua and Barbuda,ANT,0,0,0,0,1,0,1,98069,17.060816,-61.796428
summer,2012,London,Great Britain,Argentina,ARG,0,1,4,5,47,10,57,45267449,-38.416097,-63.616672
summer,2012,London,Great Britain,Armenia,ARM,0,0,0,0,0,2,2,2964219,40.069099,45.038189
summer,2012,London,Great Britain,Australia,AUS,32,23,30,85,88,70,158,25550683,-25.274398,133.775136
summer,2012,London,Great Britain,Austria,AUT,4,3,6,13,27,5,32,9015361,47.516231,14.550072
summer,2012,London,Great Britain,Azerbaijan,AZE,4,5,3,12,16,5,21,10154978,40.143105,47.576927
summer,2012,London,Great Britain,Bahrain,BRN,0,0,0,0,1,1,2,1711057,25.930414,50.637772
summer,2012,London,Great Britain,Barbados,BAR,0,0,0,0,1,0,1,287437,13.193887,-59.543198
summer,2012,London,Great Britain,Belarus,BLR,5,2,3,10,15,14,29,9448772,53.709807,27.953389
summer,2012,London,Great Britain,Belgium,BEL,3,1,3,7,31,9,40,11598451,50.503887,4.469936
summer,2012,London,Great Britain,Benin,BEN,0,0,0,0,1,0,1,12175480,9.30769,2.315834
summer,2012,London,Great Britain,Bermuda,BER,0,0,0,0,0,1,1,62237,32.321384,-64.75737
summer,2012,London,Great Britain,Bosnia and Herzegovina,BIH,1,0,0,1,11,1,12,3277152,43.915886,17.679076
summer,2012,London,Great Britain,Brazil,BRA,21,14,8,43,110,68,178,212821986,-14.235004,-51.92528
summer,2012,London,Great Britain,Brunei Darussalam,BRU,0,0,0,0,1,0,1,438202,4.535277,114.727669
summer,2012,London,Great Britain,Bulgaria,BUL,0,2,1,3,4,4,8,6939018,42.733883,25.48583
summer,2012,London,Great Britain,Burkina Faso,BUR,0,0,0,0,1,1,2,20997293,12.238333,-1.561593
summer,2012,London,Great Britain,Burundi,BDI,0,0,0,0,1,0,1,11948454,-3.373056,29.918886
summer,2012,London,Great Britain,Cambodia,CAM,0,0,0,0,0,1,1,16758448,12.565679,104.990963
summer,2012,London,Great Britain,Cameroon,CMR,0,0,0,0,1,0,1,26655083,7.369722,12.354722
summer,2012,London,Great Britain,Canada,CAN,7,15,9,31,87,57,144,37799407,56.130366,-106.346771
summer,2012,London,Great Britain,Cape Verde,CPV,0,0,0,0,1,0,1,549935,16.002082,-24.013197
summer,2012,London,Great Britain,Central African Republic,CAF,0,0,0,0,1,0,1,4843954,6.611111,20.939444
summer,2012,London,Great Britain,Chile,CHI,1,0,0,1,4,3,7,19144605,-35.675147,-71.542969
summer,2012,London,Great Britain,United States of America ,CHN,95,71,65,231,154,128,282,#N/A,#N/A,#N/A
summer,2012,London,Great Britain,Chinese Taipei,TPE,0,1,2,3,9,9,18,23816775,25.105497,121.597366
summer,2012,London,Great Britain,Colombia,COL,0,2,0,2,30,7,37,50976248,4.570868,-74.297333
summer,2012,London,Great Britain,Comoros,COM,0,0,0,0,1,0,1,872695,-11.875001,43.872219
summer,2012,London,Great Britain,Costa Rica,CRC,0,0,0,0,2,0,2,5102158,9.748917,-83.753428
summer,2012,London,Great Britain,Côte d'Ivoire,CIV,0,0,0,0,3,1,4,26486282,7.539989,-5.54708
summer,2012,London,Great Britain,Croatia,CRO,0,2,3,5,18,7,25,4100719,45.1,15.2
summer,2012,London,Great Britain,Cuba,CUB,9,5,3,17,18,4,22,11325391,21.521757,-77.781167
summer,2012,London,Great Britain,Cyprus,CYP,0,1,0,1,2,1,3,1208886,35.126413,33.429859
summer,2012,London,Great Britain,Czech Republic,CZE,1,6,4,11,31,15,46,10712481,49.817492,15.472962
summer,2012,London,Great Britain,Denmark,DEN,1,0,4,5,15,13,28,5795780,56.26392,9.501785
summer,2012,London,Great Britain,Djibouti,DJI,0,0,0,0,1,0,1,990447,11.825138,42.590275
summer,2012,London,Great Britain,Dominican Republic,DOM,0,0,0,0,2,0,2,10866667,18.735693,-70.162651
summer,2012,London,Great Britain,Democratic Republic of the Congo,COD,0,0,0,0,1,1,2,#N/A,#N/A,#N/A
summer,2012,London,Great Britain,Ecuador,ECU,0,0,0,0,1,1,2,17688599,-1.831239,-78.183406
summer,2012,London,Great Britain,Egypt,EGY,4,4,7,15,29,11,40,102659126,26.820553,30.802498
summer,2012,London,Great Britain,El Salvador,ESA,0,0,0,0,1,0,1,6491923,13.794185,-88.89653
summer,2012,London,Great Britain,Estonia,EST,0,0,0,0,2,1,3,1326693,58.595272,25.013607
summer,2012,London,Great Britain,Ethiopia,ETH,0,1,0,1,3,1,4,115434444,9.145,40.489673
summer,2012,London,Great Britain,Faroe Islands,FRO,0,0,0,0,1,0,1,48678,61.892635,-6.911806
summer,2012,London,Great Britain,Fiji,FIJ,1,0,0,1,1,0,1,897573,-16.578193,179.414413
summer,2012,London,Great Britain,Finland,FIN,4,1,1,6,21,14,35,5542237,61.92411,25.748151
summer,2012,London,Great Britain,France,FRA,8,19,18,45,101,51,152,65298930,46.227638,2.213749
summer,2012,London,Great Britain,Gabon,GAB,0,0,0,0,1,0,1,2234448,-0.803689,11.609444
summer,2012,London,Great Britain,Gambia,GAM,0,0,0,0,1,1,2,2427782,13.443182,-15.310139
summer,2012,London,Great Britain,Georgia,GEO,0,0,0,0,2,0,2,3987805,42.315407,43.356892
summer,2012,London,Great Britain,Germany,GER,18,26,22,66,88,62,150,83830972,51.165691,10.451526
summer,2012,London,Great Britain,Ghana,GHA,0,0,0,0,3,1,4,31181428,7.946527,-1.023194
summer,2012,London,Great Britain,Great Britain,GBR,34,43,43,120,177,109,286,67948282,55.378051,-3.435973
summer,2012,London,Great Britain,Greece,GRE,1,3,8,12,47,13,60,10413936,39.074208,21.824312
summer,2012,London,Great Britain,Guatemala,GUA,0,0,0,0,1,0,1,17971382,15.783471,-90.230759
summer,2012,London,Great Britain,Guinea-Bissau,GBS,0,0,0,0,1,1,2,1975718,11.803749,-15.180413
summer,2012,London,Great Britain,Haiti,HAI,0,0,0,0,2,1,3,11426356,18.971187,-72.285215
summer,2012,London,Great Britain,Honduras,HON,0,0,0,0,1,0,1,9931333,15.199999,-86.241905
summer,2012,London,Great Britain,"Hong Kong, China",HKG,3,3,6,12,13,15,28,7507523,22.396428,114.109497
summer,2012,London,Great Britain,Hungary,HUN,2,6,6,14,19,14,33,9655983,47.162494,19.503304
summer,2012,London,Great Britain,Iceland,ISL,1,0,0,1,2,2,4,341628,64.963051,-19.020835
summer,2012,London,Great Britain,India,IND,0,1,0,1,10,0,10,1382345085,20.593684,78.96288
summer,2012,London,Great Britain,Indonesia,INA,0,0,1,1,3,1,4,274021604,-0.789275,113.921327
summer,2012,London,Great Britain,Iran,IRI,10,7,7,24,70,7,77,84176929,32.427908,53.688046
summer,2012,London,Great Britain,Iraq,IRQ,0,2,1,3,16,3,19,40372771,33.223191,43.679291
summer,2012,London,Great Britain,Ireland,IRL,8,3,5,16,28,17,45,4947267,53.41291,-8.24389
summer,2012,London,Great Britain,Israel,ISR,1,2,5,8,18,7,25,8678517,31.046051,34.851612
summer,2012,London,Great Britain,Italy,ITA,9,8,11,28,65,31,96,60446035,41.87194,12.56738
summer,2012,London,Great Britain,Jamaica,JAM,1,0,0,1,2,1,3,2963429,18.109581,-77.297508
summer,2012,London,Great Britain,Japan,JPN,5,5,6,16,89,45,134,126407422,36.204824,138.252924
summer,2012,London,Great Britain,Jordan,JOR,0,0,0,0,4,4,8,10220604,30.585164,36.238414
summer,2012,London,Great Britain,Kazakhstan,KAZ,0,0,0,0,4,3,7,18815231,48.019573,66.923684
summer,2012,London,Great Britain,Kenya,KEN,2,2,2,6,10,2,12,53968739,-0.023559,37.906193
summer,2012,London,Great Britain,South Korea,KOR,9,9,9,27,60,28,88,51276977,35.907757,127.766922
summer,2012,London,Great Britain,North Korea,PRK,0,0,0,0,1,0,1,25798588,40.339852,127.510093
summer,2012,London,Great Britain,Kuwait,KUW,0,0,0,0,6,0,6,4281320,29.31166,47.481766
summer,2012,London,Great Britain,Kyrgyzstan,KGZ,0,0,0,0,1,0,1,6542426,41.20438,74.766098
summer,2012,London,Great Britain,Laos,LAO,0,0,0,0,1,0,1,7293542,19.85627,102.495496
summer,2012,London,Great Britain,Latvia,LAT,1,1,0,2,6,2,8,1882408,56.879635,24.603189
summer,2012,London,Great Britain,Lebanon,LBN,0,0,0,0,1,0,1,6819976,33.854721,35.862285
summer,2012,London,Great Britain,Lesotho,LES,0,0,0,0,0,1,1,2145194,-29.609988,28.233608
summer,2012,London,Great Britain,Liberia,LBR,0,0,0,0,1,0,1,5077411,6.428055,-9.429499
summer,2012,London,Great Britain,Libya,LBA,0,0,0,0,2,0,2,6887247,26.3351,17.228331
summer,2012,London,Great Britain,Lithuania,LTU,0,0,0,0,9,2,11,2715340,55.169438,23.881275
summer,2012,London,Great Britain,"Macao, China",MAC,0,0,0,0,1,1,2,650846,22.210928,113.552971
summer,2012,London,Great Britain,Madagascar,MAD,0,0,0,0,1,0,1,27808395,-18.766947,46.869107
summer,2012,London,Great Britain,Malaysia,MAS,0,1,1,2,16,6,22,32436963,4.210484,101.975766
summer,2012,London,Great Britain,Mali,MLI,0,0,0,0,1,0,1,20346106,17.570692,-3.996166
summer,2012,London,Great Britain,Malta,MLT,0,0,0,0,1,0,1,441750,35.937496,14.375416
summer,2012,London,Great Britain,Mauritania,MTN,0,0,0,0,1,1,2,4669775,21.00789,-10.940835
summer,2012,London,Great Britain,Mauritius,MRI,0,0,0,0,1,1,2,1272140,-20.348404,57.552152
summer,2012,London,Great Britain,Mexico,MEX,6,4,11,21,37,44,81,129166028,23.634501,-102.552784
summer,2012,London,Great Britain,Moldova,MDA,0,0,0,0,1,1,2,4032294,47.411631,28.369885
summer,2012,London,Great Britain,Mongolia,MGL,0,0,0,0,3,3,6,3287242,46.862496,103.846656
summer,2012,London,Great Britain,Montenegro,MNE,0,0,0,0,0,1,1,628080,42.708678,19.37439
summer,2012,London,Great Britain,Morocco,MAR,3,0,3,6,24,6,30,36985624,31.791702,-7.09262
summer,2012,London,Great Britain,Mozambique,MOZ,0,0,0,0,1,1,2,31398811,-18.665695,35.529562
summer,2012,London,Great Britain,Myanmar,MYA,0,0,0,0,2,0,2,54473253,21.913965,95.956223
summer,2012,London,Great Britain,Namibia,NAM,1,1,0,2,4,1,5,2548663,-22.95764,18.49041
summer,2012,London,Great Britain,Nepal,NEP,0,0,0,0,1,1,2,29225196,28.394857,84.124008
summer,2012,London,Great Britain,Netherlands,NED,10,10,19,39,39,49,88,17141544,52.132633,5.291266
summer,2012,London,Great Britain,New Zealand,NZL,6,7,4,17,11,12,23,4829021,-40.900557,174.885971
summer,2012,London,Great Britain,Nicaragua,NCA,0,0,0,0,1,1,2,6638075,12.865416,-85.207229
summer,2012,London,Great Britain,Niger,NIG,0,0,0,0,1,1,2,24346468,17.607789,8.081666
summer,2012,London,Great Britain,Nigeria,NGR,6,5,2,13,17,12,29,206984347,9.081999,8.675277
summer,2012,London,Great Britain,North Macedonia,MKD,1,0,0,1,1,1,2,2083359,41.608635,21.745275
summer,2012,London,Great Britain,Norway,NOR,3,2,3,8,13,9,22,5428594,60.472024,8.468946
summer,2012,London,Great Britain,Oman,OMA,0,0,0,0,2,0,2,5128058,21.512583,55.923255
summer,2012,London,Great Britain,Pakistan,PAK,0,0,0,0,2,0,2,221612785,30.375321,69.345116
summer,2012,London,Great Britain,Palestine,PLE,0,0,0,0,2,0,2,5121112,31.952162,35.233154
summer,2012,London,Great Britain,Panama,PAN,0,0,0,0,1,1,2,4326296,8.537981,-80.782127
summer,2012,London,Great Britain,Papua New Guinea,PNG,0,0,0,0,2,0,2,8975531,-6.314993,143.95555
summer,2012,London,Great Britain,Peru,PER,0,0,0,0,1,0,1,33050211,-9.189967,-75.015152
summer,2012,London,Great Britain,Philippines,PHI,0,0,0,0,4,5,9,109830324,12.879721,121.774017
summer,2012,London,Great Britain,Poland,POL,14,13,9,36,64,35,99,37839255,51.919438,19.145136
summer,2012,London,Great Britain,Portugal,POR,0,1,2,3,22,8,30,10191409,39.399872,-8.224454
summer,2012,London,Great Britain,Puerto Rico,PUR,0,0,0,0,2,0,2,2846860,18.220833,-66.590149
summer,2012,London,Great Britain,Qatar,QAT,0,0,0,0,1,0,1,2889284,25.354826,51.183884
summer,2012,London,Great Britain,Romania,ROU,1,1,0,2,4,1,5,19214608,45.943161,24.96676
summer,2012,London,Great Britain,Russia,RUS,36,38,28,102,120,61,181,145945524,61.52401,105.318756
summer,2012,London,Great Britain,Rwanda,RWA,0,0,0,0,14,0,14,13005303,-1.940278,29.873888
summer,2012,London,Great Britain,Samoa,SAM,0,0,0,0,1,1,2,198643,-13.759029,-172.104629
summer,2012,London,Great Britain,San Marino,SMR,0,0,0,0,1,0,1,33944,43.94236,12.457777
summer,2012,London,Great Britain,Saudi Arabia,KSA,0,1,0,1,4,0,4,34905942,23.885942,45.079162
summer,2012,London,Great Britain,Senegal,SEN,0,0,0,0,1,0,1,16816539,14.497401,-14.452362
summer,2012,London,Great Britain,Serbia,SRB,2,3,0,5,9,4,13,8731081,44.016521,21.005859
summer,2012,London,Great Britain,Sierra Leone,SLE,0,0,0,0,1,0,1,8004158,8.460555,-11.779889
summer,2012,London,Great Britain,Singapore,SGP,0,1,1,2,2,6,8,5858322,1.352083,103.819836
summer,2012,London,Great Britain,Slovakia,SVK,2,1,3,6,25,8,33,5460109,48.669026,19.699024
summer,2012,London,Great Britain,Slovenia,SLO,0,1,0,1,7,15,22,2078989,46.151241,14.995463
summer,2012,London,Great Britain,Solomon Islands,SOL,0,0,0,0,0,1,1,689671,-9.64571,160.156194
summer,2012,London,Great Britain,South Africa,RSA,8,12,9,29,44,18,62,59436725,-30.559482,22.937506
summer,2012,London,Great Britain,Spain,ESP,8,18,16,42,98,29,127,46757980,40.463667,-3.74922
summer,2012,London,Great Britain,Sri Lanka,SRI,0,0,1,1,6,1,7,21428970,7.873054,80.771797
summer,2012,London,Great Britain,Suriname,SUR,0,0,0,0,1,0,1,587541,3.919305,-56.027783
summer,2012,London,Great Britain,Sweden,SWE,4,4,4,12,40,19,59,10110233,60.128161,18.643501
summer,2012,London,Great Britain,Switzerland,SUI,3,6,4,13,15,10,25,8665615,46.818188,8.227512
summer,2012,London,Great Britain,Syrian,SYR,0,0,0,0,3,2,5,17500658,34.8149,39.0465
summer,2012,London,Great Britain,Tajikistan,TJK,0,0,0,0,1,0,1,9573310,38.861034,71.276093
summer,2012,London,Great Britain,United Republic of the Tanzania,TAN,0,0,0,0,1,0,1,#N/A,#N/A,#N/A
summer,2012,London,Great Britain,Thailand,THA,4,2,2,8,38,11,49,69830779,15.870032,100.992541
summer,2012,London,Great Britain,Timor-Leste,TLS,0,0,0,0,1,0,1,1322667,-8.874217,125.727539
summer,2012,London,Great Britain,Tonga,TGA,0,0,0,0,1,0,1,105901,-21.178986,-175.198242
summer,2012,London,Great Britain,Trinidad and Tobago,TTO,0,0,0,0,1,1,2,1400283,10.691803,-61.222503
summer,2012,London,Great Britain,Tunisia,TUN,9,5,5,19,18,13,31,11839918,33.886917,9.537499
summer,2012,London,Great Britain,Turkey,TUR,1,5,4,10,46,21,67,84495243,38.963745,35.243322
summer,2012,London,Great Britain,Turkmenistan,TKM,0,0,0,0,3,2,5,6046292,38.969719,59.556278
summer,2012,London,Great Britain,US Virgin Islands,ISV,0,0,0,0,0,1,1,104398,18.420695,-64.639968
summer,2012,London,Great Britain,Uganda,UGA,0,0,0,0,1,1,2,45974931,1.373333,32.290275
summer,2012,London,Great Britain,Ukraine,UKR,32,24,28,84,83,65,148,43686577,48.379433,31.16558
summer,2012,London,Great Britain,United Arab Emirates,UAE,1,1,1,3,11,4,15,9910892,23.424076,53.847818
summer,2012,London,Great Britain,United States of America ,USA,31,29,38,98,128,93,221,#N/A,#N/A,#N/A
summer,2012,London,Great Britain,Uruguay,URU,0,0,0,0,1,0,1,3475842,-32.522779,-55.765835
summer,2012,London,Great Britain,Uzbekistan,UZB,0,1,0,1,8,2,10,33551824,41.377491,64.585262
summer,2012,London,Great Britain,Vanuatu,VAN,0,0,0,0,1,0,1,308337,-15.376706,166.959158
summer,2012,London,Great Britain,Venezuela,VEN,0,0,2,2,21,6,27,28421581,6.42375,-66.58973
summer,2012,London,Great Britain,Vietnam,VIE,0,0,0,0,6,5,11,97490013,14.058324,108.277199
summer,2012,London,Great Britain,Zambia,ZAM,0,0,0,0,1,1,2,18468257,-13.133897,27.849332
summer,2012,London,Great Britain,Zimbabwe,ZIM,0,0,0,0,2,0,2,14899771,-19.015438,29.154857
summer,2016,Rio de Janeiro,Brazil,Afghanistan,AFG,0,0,0,0,1,0,1,39074280,33.93911,67.709953
summer,2016,Rio de Janeiro,Brazil,Algeria,ALG,4,5,7,16,34,26,60,43984569,28.033886,1.659626
summer,2016,Rio de Janeiro,Brazil,Angola,ANG,0,0,0,0,2,2,4,33032075,-11.202692,17.873887
summer,2016,Rio de Janeiro,Brazil,Argentina,ARG,1,1,3,5,56,26,82,45267449,-38.416097,-63.616672
summer,2016,Rio de Janeiro,Brazil,Armenia,ARM,0,0,0,0,0,2,2,2964219,40.069099,45.038189
summer,2016,Rio de Janeiro,Brazil,Aruba,ARU,0,0,0,0,1,0,1,106845,12.52111,-69.968338
summer,2016,Rio de Janeiro,Brazil,Australia,AUS,22,30,29,81,101,69,170,25550683,-25.274398,133.775136
summer,2016,Rio de Janeiro,Brazil,Austria,AUT,1,4,4,9,21,6,27,9015361,47.516231,14.550072
summer,2016,Rio de Janeiro,Brazil,Azerbaijan,AZE,1,8,2,11,18,5,23,10154978,40.143105,47.576927
summer,2016,Rio de Janeiro,Brazil,Bahrain,BRN,1,0,0,1,0,2,2,1711057,25.930414,50.637772
summer,2016,Rio de Janeiro,Brazil,Belarus,BLR,8,0,2,10,10,10,20,9448772,53.709807,27.953389
summer,2016,Rio de Janeiro,Brazil,Belgium,BEL,5,3,3,11,19,10,29,11598451,50.503887,4.469936
summer,2016,Rio de Janeiro,Brazil,Benin,BEN,0,0,0,0,1,0,1,12175480,9.30769,2.315834
summer,2016,Rio de Janeiro,Brazil,Bermuda,BER,0,0,0,0,0,2,2,62237,32.321384,-64.75737
summer,2016,Rio de Janeiro,Brazil,Bosnia and Herzegovina,BIH,0,1,0,1,13,1,14,3277152,43.915886,17.679076
summer,2016,Rio de Janeiro,Brazil,Botswana,BOT,0,0,0,0,1,0,1,2359585,-22.328474,24.684866
summer,2016,Rio de Janeiro,Brazil,Brazil,BRA,14,29,29,72,184,102,286,212821986,-14.235004,-51.92528
summer,2016,Rio de Janeiro,Brazil,Bulgaria,BUL,1,0,0,1,4,3,7,6939018,42.733883,25.48583
summer,2016,Rio de Janeiro,Brazil,Burkina Faso,BUR,0,0,0,0,1,0,1,20997293,12.238333,-1.561593
summer,2016,Rio de Janeiro,Brazil,Burundi,BDI,0,0,0,0,1,0,1,11948454,-3.373056,29.918886
summer,2016,Rio de Janeiro,Brazil,Cambodia,CAM,0,0,0,0,1,0,1,16758448,12.565679,104.990963
summer,2016,Rio de Janeiro,Brazil,Cameroon,CMR,0,0,0,0,1,0,1,26655083,7.369722,12.354722
summer,2016,Rio de Janeiro,Brazil,Canada,CAN,8,10,11,29,80,73,153,37799407,56.130366,-106.346771
summer,2016,Rio de Janeiro,Brazil,Cape Verde,CPV,0,0,1,1,2,0,2,549935,16.002082,-24.013197
summer,2016,Rio de Janeiro,Brazil,Central African Republic,CAF,0,0,0,0,1,0,1,4843954,6.611111,20.939444
summer,2016,Rio de Janeiro,Brazil,Chile,CHI,0,0,0,0,7,8,15,19144605,-35.675147,-71.542969
summer,2016,Rio de Janeiro,Brazil,United States of America ,CHN,107,81,51,239,161,146,307,#N/A,#N/A,#N/A
summer,2016,Rio de Janeiro,Brazil,Chinese Taipei,TPE,0,1,1,2,5,8,13,23816775,25.105497,121.597366
summer,2016,Rio de Janeiro,Brazil,Colombia,COL,2,5,10,17,26,13,39,50976248,4.570868,-74.297333
summer,2016,Rio de Janeiro,Brazil,Democratic Republic of the Congo,CGO,0,0,0,0,1,0,1,#N/A,#N/A,#N/A
summer,2016,Rio de Janeiro,Brazil,Costa Rica,CRC,0,0,0,0,2,1,3,5102158,9.748917,-83.753428
summer,2016,Rio de Janeiro,Brazil,Côte d'Ivoire,CIV,0,1,0,1,3,2,5,26486282,7.539989,-5.54708
summer,2016,Rio de Janeiro,Brazil,Croatia,CRO,2,2,1,5,12,7,19,4100719,45.1,15.2
summer,2016,Rio de Janeiro,Brazil,Cuba,CUB,8,1,6,15,16,6,22,11325391,21.521757,-77.781167
summer,2016,Rio de Janeiro,Brazil,Cyprus,CYP,0,0,0,0,1,1,2,1208886,35.126413,33.429859
summer,2016,Rio de Janeiro,Brazil,Czech Republic,CZE,1,2,4,7,23,14,37,10712481,49.817492,15.472962
summer,2016,Rio de Janeiro,Brazil,Denmark,DEN,1,2,4,7,13,8,21,5795780,56.26392,9.501785
summer,2016,Rio de Janeiro,Brazil,Dominican Republic,DOM,0,0,0,0,2,0,2,10866667,18.735693,-70.162651
summer,2016,Rio de Janeiro,Brazil,Democratic Republic of the Congo,COD,0,0,0,0,1,1,2,#N/A,#N/A,#N/A
summer,2016,Rio de Janeiro,Brazil,Ecuador,ECU,0,0,0,0,4,1,5,17688599,-1.831239,-78.183406
summer,2016,Rio de Janeiro,Brazil,Egypt,EGY,3,5,4,12,34,11,45,102659126,26.820553,30.802498
summer,2016,Rio de Janeiro,Brazil,El Salvador,ESA,0,0,0,0,1,0,1,6491923,13.794185,-88.89653
summer,2016,Rio de Janeiro,Brazil,Estonia,EST,0,0,0,0,2,4,6,1326693,58.595272,25.013607
summer,2016,Rio de Janeiro,Brazil,Ethiopia,ETH,0,1,0,1,4,1,5,115434444,9.145,40.489673
summer,2016,Rio de Janeiro,Brazil,Faroe Islands,FRO,0,0,0,0,0,1,1,48678,61.892635,-6.911806
summer,2016,Rio de Janeiro,Brazil,Fiji,FIJ,0,0,0,0,1,1,2,897573,-16.578193,179.414413
summer,2016,Rio de Janeiro,Brazil,Finland,FIN,1,1,1,3,19,7,26,5542237,61.92411,25.748151
summer,2016,Rio de Janeiro,Brazil,France,FRA,9,5,14,28,80,42,122,65298930,46.227638,2.213749
summer,2016,Rio de Janeiro,Brazil,Gabon,GAB,0,0,0,0,1,0,1,2234448,-0.803689,11.609444
summer,2016,Rio de Janeiro,Brazil,Gambia,GAM,0,0,0,0,1,0,1,2427782,13.443182,-15.310139
summer,2016,Rio de Janeiro,Brazil,Georgia,GEO,1,0,0,1,3,2,5,3987805,42.315407,43.356892
summer,2016,Rio de Janeiro,Brazil,Germany,GER,18,25,14,57,89,66,155,83830972,51.165691,10.451526
summer,2016,Rio de Janeiro,Brazil,Ghana,GHA,0,0,0,0,3,0,3,31181428,7.946527,-1.023194
summer,2016,Rio de Janeiro,Brazil,Great Britain,GBR,64,39,44,147,151,100,251,67948282,55.378051,-3.435973
summer,2016,Rio de Janeiro,Brazil,Greece,GRE,5,4,4,13,44,16,60,10413936,39.074208,21.824312
summer,2016,Rio de Janeiro,Brazil,Guatemala,GUA,0,0,0,0,1,0,1,17971382,15.783471,-90.230759
summer,2016,Rio de Janeiro,Brazil,Guinea,GUY,0,0,0,0,1,0,1,13191279,9.945587,-9.696645
summer,2016,Rio de Janeiro,Brazil,Guinea-Bissau,GBS,0,0,0,0,1,0,1,1975718,11.803749,-15.180413
summer,2016,Rio de Janeiro,Brazil,Haiti,HAI,0,0,0,0,1,0,1,11426356,18.971187,-72.285215
summer,2016,Rio de Janeiro,Brazil,Honduras,HON,0,0,0,0,2,0,2,9931333,15.199999,-86.241905
summer,2016,Rio de Janeiro,Brazil,"Hong Kong, China",HKG,2,2,2,6,9,15,24,7507523,22.396428,114.109497
summer,2016,Rio de Janeiro,Brazil,Hungary,HUN,1,8,9,18,19,24,43,9655983,47.162494,19.503304
summer,2016,Rio de Janeiro,Brazil,Iceland,ISL,0,0,0,0,3,2,5,341628,64.963051,-19.020835
summer,2016,Rio de Janeiro,Brazil,India,IND,2,1,1,4,16,3,19,1382345085,20.593684,78.96288
summer,2016,Rio de Janeiro,Brazil,Indonesia,INA,0,0,1,1,6,3,9,274021604,-0.789275,113.921327
summer,2016,Rio de Janeiro,Brazil,Iran,IRI,8,9,7,24,85,23,108,84176929,32.427908,53.688046
summer,2016,Rio de Janeiro,Brazil,Iraq,IRQ,2,3,0,5,12,2,14,40372771,33.223191,43.679291
summer,2016,Rio de Janeiro,Brazil,Ireland,IRL,4,4,3,11,30,14,44,4947267,53.41291,-8.24389
summer,2016,Rio de Janeiro,Brazil,Israel,ISR,0,0,3,3,17,16,33,8678517,31.046051,34.851612
summer,2016,Rio de Janeiro,Brazil,Italy,ITA,10,14,15,39,60,40,100,60446035,41.87194,12.56738
summer,2016,Rio de Janeiro,Brazil,Jamaica,JAM,0,0,0,0,2,1,3,2963429,18.109581,-77.297508
summer,2016,Rio de Janeiro,Brazil,Japan,JPN,0,10,14,24,86,46,132,126407422,36.204824,138.252924
summer,2016,Rio de Janeiro,Brazil,Jordan,JOR,0,2,1,3,7,3,10,10220604,30.585164,36.238414
summer,2016,Rio de Janeiro,Brazil,Kazakhstan,KAZ,1,1,0,2,7,4,11,18815231,48.019573,66.923684
summer,2016,Rio de Janeiro,Brazil,Kenya,KEN,3,1,2,6,7,2,9,53968739,-0.023559,37.906193
summer,2016,Rio de Janeiro,Brazil,South Korea,KOR,7,11,17,35,53,29,82,51276977,35.907757,127.766922
summer,2016,Rio de Janeiro,Brazil,North Korea,PRK,0,0,0,0,1,1,2,25798588,40.339852,127.510093
summer,2016,Rio de Janeiro,Brazil,Kuwait,KUW,1,0,0,1,6,0,6,4281320,29.31166,47.481766
summer,2016,Rio de Janeiro,Brazil,Kyrgyzstan,KGZ,0,0,0,0,3,0,3,6542426,41.20438,74.766098
summer,2016,Rio de Janeiro,Brazil,Laos,LAO,0,0,0,0,1,0,1,7293542,19.85627,102.495496
summer,2016,Rio de Janeiro,Brazil,Latvia,LAT,2,0,2,4,6,5,11,1882408,56.879635,24.603189
summer,2016,Rio de Janeiro,Brazil,Lesotho,LES,0,0,0,0,1,1,2,2145194,-29.609988,28.233608
summer,2016,Rio de Janeiro,Brazil,Libya,LBA,0,0,0,0,1,2,3,6887247,26.3351,17.228331
summer,2016,Rio de Janeiro,Brazil,Lithuania,LTU,2,1,0,3,12,1,13,2715340,55.169438,23.881275
summer,2016,Rio de Janeiro,Brazil,Luxembourg,LUX,0,0,0,0,3,0,3,627704,49.815273,6.129583
summer,2016,Rio de Janeiro,Brazil,"Macao, China",MAC,0,0,0,0,1,0,1,650846,22.210928,113.552971
summer,2016,Rio de Janeiro,Brazil,Madagascar,MAD,0,0,0,0,1,0,1,27808395,-18.766947,46.869107
summer,2016,Rio de Janeiro,Brazil,Malawi,MAW,0,0,0,0,0,1,1,19211425,-13.254308,34.301525
summer,2016,Rio de Janeiro,Brazil,Malaysia,MAS,3,0,1,4,17,2,19,32436963,4.210484,101.975766
summer,2016,Rio de Janeiro,Brazil,Mali,MLI,0,0,0,0,1,1,2,20346106,17.570692,-3.996166
summer,2016,Rio de Janeiro,Brazil,Malta,MLT,0,0,0,0,0,1,1,441750,35.937496,14.375416
summer,2016,Rio de Janeiro,Brazil,Mauritius,MRI,0,0,0,0,1,1,2,1272140,-20.348404,57.552152
summer,2016,Rio de Janeiro,Brazil,Mexico,MEX,4,2,9,15,37,32,69,129166028,23.634501,-102.552784
summer,2016,Rio de Janeiro,Brazil,Moldova,MDA,0,0,0,0,1,2,3,4032294,47.411631,28.369885
summer,2016,Rio de Janeiro,Brazil,Mongolia,MGL,0,0,2,2,6,2,8,3287242,46.862496,103.846656
summer,2016,Rio de Janeiro,Brazil,Montenegro,MNE,0,0,0,0,1,1,2,628080,42.708678,19.37439
summer,2016,Rio de Janeiro,Brazil,Morocco,MAR,3,2,2,7,18,6,24,36985624,31.791702,-7.09262
summer,2016,Rio de Janeiro,Brazil,Mozambique,MOZ,0,0,1,1,0,1,1,31398811,-18.665695,35.529562
summer,2016,Rio de Janeiro,Brazil,Myanmar,MYA,0,0,0,0,2,0,2,54473253,21.913965,95.956223
summer,2016,Rio de Janeiro,Brazil,Namibia,NAM,1,2,2,5,7,2,9,2548663,-22.95764,18.49041
summer,2016,Rio de Janeiro,Brazil,Nepal,NEP,0,0,0,0,1,1,2,29225196,28.394857,84.124008
summer,2016,Rio de Janeiro,Brazil,Netherlands,NED,17,19,26,62,58,62,120,17141544,52.132633,5.291266
summer,2016,Rio de Janeiro,Brazil,New Zealand,NZL,9,5,7,21,17,12,29,4829021,-40.900557,174.885971
summer,2016,Rio de Janeiro,Brazil,Nicaragua,NCA,0,0,0,0,2,1,3,6638075,12.865416,-85.207229
summer,2016,Rio de Janeiro,Brazil,Niger,NIG,0,0,0,0,1,1,2,24346468,17.607789,8.081666
summer,2016,Rio de Janeiro,Brazil,Nigeria,NGR,8,2,2,12,9,13,22,206984347,9.081999,8.675277
summer,2016,Rio de Janeiro,Brazil,North Macedonia,MKD,0,0,0,0,1,1,2,2083359,41.608635,21.745275
summer,2016,Rio de Janeiro,Brazil,Norway,NOR,3,2,3,8,12,13,25,5428594,60.472024,8.468946
summer,2016,Rio de Janeiro,Brazil,Oman,OMA,0,0,0,0,1,1,2,5128058,21.512583,55.923255
summer,2016,Rio de Janeiro,Brazil,Pakistan,PAK,0,0,1,1,1,0,1,221612785,30.375321,69.345116
summer,2016,Rio de Janeiro,Brazil,Palestine,PLE,0,0,0,0,1,0,1,5121112,31.952162,35.233154
summer,2016,Rio de Janeiro,Brazil,Panama,PAN,0,0,0,0,1,1,2,4326296,8.537981,-80.782127
summer,2016,Rio de Janeiro,Brazil,Papua New Guinea,PNG,0,0,0,0,1,1,2,8975531,-6.314993,143.95555
summer,2016,Rio de Janeiro,Brazil,Peru,PER,0,0,0,0,5,1,6,33050211,-9.189967,-75.015152
summer,2016,Rio de Janeiro,Brazil,Philippines,PHI,0,0,1,1,3,2,5,109830324,12.879721,121.774017
summer,2016,Rio de Janeiro,Brazil,Poland,POL,9,18,12,39,54,36,90,37839255,51.919438,19.145136
summer,2016,Rio de Janeiro,Brazil,Portugal,POR,0,0,4,4,25,12,37,10191409,39.399872,-8.224454
summer,2016,Rio de Janeiro,Brazil,Puerto Rico,PUR,0,0,0,0,3,1,4,2846860,18.220833,-66.590149
summer,2016,Rio de Janeiro,Brazil,Qatar,QAT,0,2,0,2,2,1,3,2889284,25.354826,51.183884
summer,2016,Rio de Janeiro,Brazil,Romania,ROU,0,0,1,1,9,3,12,19214608,45.943161,24.96676
summer,2016,Rio de Janeiro,Brazil,Rwanda,RWA,0,0,0,0,1,12,13,13005303,-1.940278,29.873888
summer,2016,Rio de Janeiro,Brazil,Samoa,SAM,0,0,0,0,1,1,2,198643,-13.759029,-172.104629
summer,2016,Rio de Janeiro,Brazil,Saudi Arabia,KSA,0,0,1,1,3,0,3,34905942,23.885942,45.079162
summer,2016,Rio de Janeiro,Brazil,Senegal,SEN,0,0,0,0,1,1,2,16816539,14.497401,-14.452362
summer,2016,Rio de Janeiro,Brazil,Serbia,SRB,3,2,4,9,13,3,16,8731081,44.016521,21.005859
summer,2016,Rio de Janeiro,Brazil,Seychelles,SEY,0,0,0,0,1,0,1,98453,-4.679574,55.491977
summer,2016,Rio de Janeiro,Brazil,Sierra Leone,SLE,0,0,0,0,1,0,1,8004158,8.460555,-11.779889
summer,2016,Rio de Janeiro,Brazil,Singapore,SGP,2,0,1,3,4,9,13,5858322,1.352083,103.819836
summer,2016,Rio de Janeiro,Brazil,Slovakia,SVK,5,3,3,11,21,7,28,5460109,48.669026,19.699024
summer,2016,Rio de Janeiro,Brazil,Slovenia,SLO,1,1,0,2,7,1,8,2078989,46.151241,14.995463
summer,2016,Rio de Janeiro,Brazil,Somalia,SOM,0,0,0,0,1,0,1,15965848,5.152149,46.199616
summer,2016,Rio de Janeiro,Brazil,South Africa,RSA,7,6,4,17,26,18,44,59436725,-30.559482,22.937506
summer,2016,Rio de Janeiro,Brazil,Spain,ESP,9,14,8,31,83,28,111,46757980,40.463667,-3.74922
summer,2016,Rio de Janeiro,Brazil,Sri Lanka,SRI,0,0,1,1,8,1,9,21428970,7.873054,80.771797
summer,2016,Rio de Janeiro,Brazil,Suriname,SUR,0,0,0,0,1,0,1,587541,3.919305,-56.027783
summer,2016,Rio de Janeiro,Brazil,Sweden,SWE,1,4,5,10,39,18,57,10110233,60.128161,18.643501
summer,2016,Rio de Janeiro,Brazil,Switzerland,SUI,2,2,1,5,14,10,24,8665615,46.818188,8.227512
summer,2016,Rio de Janeiro,Brazil,Syrian,SYR,0,0,0,0,1,1,2,17500658,34.8149,39.0465
summer,2016,Rio de Janeiro,Brazil,Tajikistan,TJK,0,0,0,0,1,0,1,9573310,38.861034,71.276093
summer,2016,Rio de Janeiro,Brazil,United Republic of the Tanzania,TAN,0,0,0,0,1,0,1,#N/A,#N/A,#N/A
summer,2016,Rio de Janeiro,Brazil,Thailand,THA,6,6,6,18,30,15,45,69830779,15.870032,100.992541
summer,2016,Rio de Janeiro,Brazil,Timor-Leste,TLS,0,0,0,0,1,1,2,1322667,-8.874217,125.727539
summer,2016,Rio de Janeiro,Brazil,Togo,TOG,0,0,0,0,1,0,1,8310934,8.619543,0.824782
summer,2016,Rio de Janeiro,Brazil,Tonga,TGA,0,0,0,0,1,1,2,105901,-21.178986,-175.198242
summer,2016,Rio de Janeiro,Brazil,Trinidad and Tobago,TTO,1,1,1,3,1,2,3,1400283,10.691803,-61.222503
summer,2016,Rio de Janeiro,Brazil,Tunisia,TUN,7,6,6,19,14,17,31,11839918,33.886917,9.537499
summer,2016,Rio de Janeiro,Brazil,Turkey,TUR,3,1,5,9,46,32,78,84495243,38.963745,35.243322
summer,2016,Rio de Janeiro,Brazil,Turkmenistan,TKM,0,0,0,0,1,1,2,6046292,38.969719,59.556278
summer,2016,Rio de Janeiro,Brazil,US Virgin Islands,ISV,0,0,0,0,1,0,1,104398,18.420695,-64.639968
summer,2016,Rio de Janeiro,Brazil,Uganda,UGA,0,1,0,1,1,0,1,45974931,1.373333,32.290275
summer,2016,Rio de Janeiro,Brazil,Ukraine,UKR,41,37,39,117,91,77,168,43686577,48.379433,31.16558
summer,2016,Rio de Janeiro,Brazil,United Arab Emirates,UAE,2,4,1,7,12,6,18,9910892,23.424076,53.847818
summer,2016,Rio de Janeiro,Brazil,United States of America ,USA,40,44,31,115,154,124,278,#N/A,#N/A,#N/A
summer,2016,Rio de Janeiro,Brazil,Uruguay,URU,0,0,0,0,3,1,4,3475842,-32.522779,-55.765835
summer,2016,Rio de Janeiro,Brazil,Uzbekistan,UZB,8,6,17,31,22,10,32,33551824,41.377491,64.585262
summer,2016,Rio de Janeiro,Brazil,Venezuela,VEN,0,3,3,6,16,8,24,28421581,6.42375,-66.58973
summer,2016,Rio de Janeiro,Brazil,Vietnam,VIE,1,1,2,4,7,4,11,97490013,14.058324,108.277199
summer,2016,Rio de Janeiro,Brazil,Zimbabwe,ZIM,0,0,0,0,2,3,5,14899771,-19.015438,29.154857
summer,2020,Tokyo,Japan,Afghanistan,AFG,0,0,0,0,1,1,2,39074280,33.93911,67.709953
summer,2020,Tokyo,Japan,Algeria,ALG,4,4,4,12,35,21,56,43984569,28.033886,1.659626
summer,2020,Tokyo,Japan,Angola,ANG,0,0,0,0,1,1,2,33032075,-11.202692,17.873887
summer,2020,Tokyo,Japan,Argentina,ARG,0,5,4,9,40,19,59,45267449,-38.416097,-63.616672
summer,2020,Tokyo,Japan,Armenia,ARM,0,0,0,0,1,0,1,2964219,40.069099,45.038189
summer,2020,Tokyo,Japan,Aruba,ARU,0,0,0,0,1,0,1,106845,12.52111,-69.968338
summer,2020,Tokyo,Japan,Australia,AUS,21,29,30,80,101,80,181,25550683,-25.274398,133.775136
summer,2020,Tokyo,Japan,Austria,AUT,1,5,3,9,18,7,25,9015361,47.516231,14.550072
summer,2020,Tokyo,Japan,Azerbaijan,AZE,14,1,4,19,24,12,36,10154978,40.143105,47.576927
summer,2020,Tokyo,Japan,Bahrain,BRN,0,0,0,0,1,1,2,1711057,25.930414,50.637772
summer,2020,Tokyo,Japan,Barbados,BAR,0,0,0,0,1,0,1,287437,13.193887,-59.543198
summer,2020,Tokyo,Japan,Belarus,BLR,5,1,1,7,12,7,19,9448772,53.709807,27.953389
summer,2020,Tokyo,Japan,Belgium,BEL,4,3,8,15,25,9,34,11598451,50.503887,4.469936
summer,2020,Tokyo,Japan,Benin,BEN,0,0,0,0,1,1,2,12175480,9.30769,2.315834
summer,2020,Tokyo,Japan,Bermuda,BER,0,0,0,0,0,1,1,62237,32.321384,-64.75737
summer,2020,Tokyo,Japan,Bhutan,BHU,0,0,0,0,2,1,3,773069,27.514162,90.433601
summer,2020,Tokyo,Japan,Bosnia and Herzegovina,BIH,0,0,1,1,14,1,15,3277152,43.915886,17.679076
summer,2020,Tokyo,Japan,Botswana,BOT,0,0,0,0,1,1,2,2359585,-22.328474,24.684866
summer,2020,Tokyo,Japan,Brazil,BRA,22,20,30,72,145,96,241,212821986,-14.235004,-51.92528
summer,2020,Tokyo,Japan,Bulgaria,BUL,0,2,0,2,2,2,4,6939018,42.733883,25.48583
summer,2020,Tokyo,Japan,Burkina Faso,BUR,0,0,0,0,1,1,2,20997293,12.238333,-1.561593
summer,2020,Tokyo,Japan,Burundi,BDI,0,0,0,0,1,1,2,11948454,-3.373056,29.918886
summer,2020,Tokyo,Japan,Cambodia,CAM,0,0,0,0,1,0,1,16758448,12.565679,104.990963
summer,2020,Tokyo,Japan,Cameroon,CMR,0,0,0,0,1,2,3,26655083,7.369722,12.354722
summer,2020,Tokyo,Japan,Canada,CAN,5,10,6,21,57,72,129,37799407,56.130366,-106.346771
summer,2020,Tokyo,Japan,Cape Verde,CPV,0,0,0,0,1,1,2,549935,16.002082,-24.013197
summer,2020,Tokyo,Japan,Central African Republic,CAF,0,0,0,0,0,1,1,4843954,6.611111,20.939444
summer,2020,Tokyo,Japan,Chile,CHI,2,3,1,6,10,9,19,19144605,-35.675147,-71.542969
summer,2020,Tokyo,Japan,Chinese Taipei,TPE,0,0,1,1,4,6,10,23816775,25.105497,121.597366
summer,2020,Tokyo,Japan,Colombia,COL,3,7,14,24,44,22,66,50976248,4.570868,-74.297333
summer,2020,Tokyo,Japan,Democratic Republic of the Congo,CGO,0,0,0,0,1,1,2,#N/A,#N/A,#N/A
summer,2020,Tokyo,Japan,Costa Rica,CRC,1,1,0,2,7,2,9,5102158,9.748917,-83.753428
summer,2020,Tokyo,Japan,Côte d'Ivoire,CIV,0,0,0,0,2,1,3,26486282,7.539989,-5.54708
summer,2020,Tokyo,Japan,Croatia,CRO,0,3,4,7,16,6,22,4100719,45.1,15.2
summer,2020,Tokyo,Japan,Cuba,CUB,4,1,1,6,13,4,17,11325391,21.521757,-77.781167
summer,2020,Tokyo,Japan,Cyprus,CYP,1,0,1,2,1,2,3,1208886,35.126413,33.429859
summer,2020,Tokyo,Japan,Czech Republic,CZE,2,3,3,8,19,10,29,10712481,49.817492,15.472962
summer,2020,Tokyo,Japan,Democratic Republic of the Congo,COD,0,0,0,0,1,1,2,#N/A,#N/A,#N/A
summer,2020,Tokyo,Japan,Denmark,DEN,3,1,1,5,16,9,25,5795780,56.26392,9.501785
summer,2020,Tokyo,Japan,Dominican Republic,DOM,0,0,0,0,3,2,5,10866667,18.735693,-70.162651
summer,2020,Tokyo,Japan,Ecuador,ECU,1,0,2,3,5,3,8,17688599,-1.831239,-78.183406
summer,2020,Tokyo,Japan,Egypt,EGY,0,5,2,7,29,20,49,102659126,26.820553,30.802498
summer,2020,Tokyo,Japan,El Salvador,ESA,0,0,1,1,2,1,3,6491923,13.794185,-88.89653
summer,2020,Tokyo,Japan,Estonia,EST,0,0,0,0,4,1,5,1326693,58.595272,25.013607
summer,2020,Tokyo,Japan,Ethiopia,ETH,1,0,0,1,2,1,3,115434444,9.145,40.489673
summer,2020,Tokyo,Japan,Faroe Islands,FRO,0,0,0,0,1,0,1,48678,61.892635,-6.911806
summer,2020,Tokyo,Japan,Fiji,FIJ,0,0,0,0,2,0,2,897573,-16.578193,179.414413
summer,2020,Tokyo,Japan,Finland,FIN,1,3,1,5,11,5,16,5542237,61.92411,25.748151
summer,2020,Tokyo,Japan,France,FRA,11,15,28,54,108,38,146,65298930,46.227638,2.213749
summer,2020,Tokyo,Japan,Gabon,GAB,0,0,0,0,1,1,2,2234448,-0.803689,11.609444
summer,2020,Tokyo,Japan,Gambia,GAM,0,0,0,0,1,1,2,2427782,13.443182,-15.310139
summer,2020,Tokyo,Japan,Georgia,GEO,0,3,0,3,9,4,13,3987805,42.315407,43.356892
summer,2020,Tokyo,Japan,Germany,GER,13,12,18,43,79,58,137,83830972,51.165691,10.451526
summer,2020,Tokyo,Japan,Ghana,GHA,0,0,0,0,3,0,3,31181428,7.946527,-1.023194
summer,2020,Tokyo,Japan,Great Britain,GBR,41,38,45,124,124,97,221,67948282,55.378051,-3.435973
summer,2020,Tokyo,Japan,Greece,GRE,1,3,7,11,34,11,45,10413936,39.074208,21.824312
summer,2020,Tokyo,Japan,Grenada,GRN,0,0,0,0,0,2,2,112614,12.262776,-61.604171
summer,2020,Tokyo,Japan,Guatemala,GUA,0,0,0,0,1,1,2,17971382,15.783471,-90.230759
summer,2020,Tokyo,Japan,Guinea,GUI,0,0,0,0,1,1,2,13191279,9.945587,-9.696645
summer,2020,Tokyo,Japan,Guinea-Bissau,GBS,0,0,0,0,1,0,1,1975718,11.803749,-15.180413
summer,2020,Tokyo,Japan,Guyana,GUY,0,0,0,0,1,0,1,787215,4.860416,-58.93018
summer,2020,Tokyo,Japan,Haiti,HAI,0,0,0,0,1,0,1,11426356,18.971187,-72.285215
summer,2020,Tokyo,Japan,Honduras,HON,0,0,0,0,1,0,1,9931333,15.199999,-86.241905
summer,2020,Tokyo,Japan,"Hong Kong, China",HKG,0,2,3,5,9,14,23,7507523,22.396428,114.109497
summer,2020,Tokyo,Japan,Hungary,HUN,7,5,4,16,19,20,39,9655983,47.162494,19.503304
summer,2020,Tokyo,Japan,Iceland,ISL,0,0,0,0,3,3,6,341628,64.963051,-19.020835
summer,2020,Tokyo,Japan,India,IND,5,8,6,19,40,14,54,1382345085,20.593684,78.96288
summer,2020,Tokyo,Japan,Indonesia,INA,2,3,4,9,14,9,23,274021604,-0.789275,113.921327
summer,2020,Tokyo,Japan,Iraq,IRQ,0,1,2,3,14,5,19,40372771,33.223191,43.679291
summer,2020,Tokyo,Japan,Ireland,IRL,4,2,1,7,15,16,31,4947267,53.41291,-8.24389
summer,2020,Tokyo,Japan,Iran,IRI,12,11,1,24,54,9,63,84176929,32.427908,53.688046
summer,2020,Tokyo,Japan,Israel,ISR,6,2,1,9,15,18,33,8678517,31.046051,34.851612
summer,2020,Tokyo,Japan,Italy,ITA,14,29,26,69,52,62,114,60446035,41.87194,12.56738
summer,2020,Tokyo,Japan,Jamaica,JAM,0,0,0,0,2,2,4,2963429,18.109581,-77.297508
summer,2020,Tokyo,Japan,Japan,JPN,13,15,23,51,153,109,262,126407422,36.204824,138.252924
summer,2020,Tokyo,Japan,Jordan,JOR,4,0,1,5,6,4,10,10220604,30.585164,36.238414
summer,2020,Tokyo,Japan,Kazakhstan,KAZ,1,3,1,5,16,10,26,18815231,48.019573,66.923684
summer,2020,Tokyo,Japan,Kenya,KEN,0,0,1,1,4,5,9,53968739,-0.023559,37.906193
summer,2020,Tokyo,Japan,Kuwait,KUW,0,1,1,2,2,1,3,4281320,29.31166,47.481766
summer,2020,Tokyo,Japan,Kyrgyzstan,KGZ,0,0,0,0,1,1,2,6542426,41.20438,74.766098
summer,2020,Tokyo,Japan,Laos,LAO,0,0,0,0,1,0,1,7293542,19.85627,102.495496
summer,2020,Tokyo,Japan,Latvia,LAT,0,3,2,5,4,3,7,1882408,56.879635,24.603189
summer,2020,Tokyo,Japan,Lebanon,LBN,0,0,0,0,1,0,1,6819976,33.854721,35.862285
summer,2020,Tokyo,Japan,Lesotho,LES,0,0,0,0,0,1,1,2145194,-29.609988,28.233608
summer,2020,Tokyo,Japan,Liberia,LBR,0,0,0,0,1,1,2,5077411,6.428055,-9.429499
summer,2020,Tokyo,Japan,Libya,LBA,0,0,0,0,2,0,2,6887247,26.3351,17.228331
summer,2020,Tokyo,Japan,Lithuania,LTU,0,0,3,3,10,1,11,2715340,55.169438,23.881275
summer,2020,Tokyo,Japan,Luxembourg,LUX,0,0,0,0,1,0,1,627704,49.815273,6.129583
summer,2020,Tokyo,Japan,Madagascar,MAD,0,0,0,0,0,1,1,27808395,-18.766947,46.869107
summer,2020,Tokyo,Japan,Malawi,MAW,0,0,0,0,0,1,1,19211425,-13.254308,34.301525
summer,2020,Tokyo,Japan,Malaysia,MAS,3,2,0,5,21,4,25,32436963,4.210484,101.975766
summer,2020,Tokyo,Japan,Maldives,MDV,0,0,0,0,1,1,2,542151,3.202778,73.22068
summer,2020,Tokyo,Japan,Mali,MLI,0,0,0,0,1,1,2,20346106,17.570692,-3.996166
summer,2020,Tokyo,Japan,Malta,MLT,0,0,0,0,1,1,2,441750,35.937496,14.375416
summer,2020,Tokyo,Japan,Mauritius,MRI,0,0,0,0,1,3,4,1272140,-20.348404,57.552152
summer,2020,Tokyo,Japan,Mexico,MEX,7,2,13,22,31,29,60,129166028,23.634501,-102.552784
summer,2020,Tokyo,Japan,Mongolia,MGL,1,0,0,1,7,4,11,3287242,46.862496,103.846656
summer,2020,Tokyo,Japan,Montenegro,MNE,0,0,1,1,4,1,5,628080,42.708678,19.37439
summer,2020,Tokyo,Japan,Morocco,MAR,4,4,3,11,23,13,36,36985624,31.791702,-7.09262
summer,2020,Tokyo,Japan,Mozambique,MOZ,0,0,0,0,1,1,2,31398811,-18.665695,35.529562
summer,2020,Tokyo,Japan,Namibia,NAM,0,1,1,2,2,1,3,2548663,-22.95764,18.49041
summer,2020,Tokyo,Japan,Nepal,NEP,0,0,0,0,0,1,1,29225196,28.394857,84.124008
summer,2020,Tokyo,Japan,Netherlands,NED,25,17,17,59,33,41,74,17141544,52.132633,5.291266
summer,2020,Tokyo,Japan,New Zealand,NZL,6,3,3,12,16,16,32,4829021,-40.900557,174.885971
summer,2020,Tokyo,Japan,Nicaragua,NCA,0,0,0,0,1,1,2,6638075,12.865416,-85.207229
summer,2020,Tokyo,Japan,Niger,NIG,0,0,0,0,1,1,2,24346468,17.607789,8.081666
summer,2020,Tokyo,Japan,Nigeria,NGR,4,1,5,10,10,12,22,206984347,9.081999,8.675277
summer,2020,Tokyo,Japan,North Macedonia,MKD,0,0,0,0,0,1,1,2083359,41.608635,21.745275
summer,2020,Tokyo,Japan,Norway,NOR,2,0,2,4,5,10,15,5428594,60.472024,8.468946
summer,2020,Tokyo,Japan,Oman,OMA,0,0,1,1,2,1,3,5128058,21.512583,55.923255
summer,2020,Tokyo,Japan,Pakistan,PAK,1,0,0,1,1,1,2,221612785,30.375321,69.345116
summer,2020,Tokyo,Japan,Palestine,PLE,0,0,0,0,1,0,1,5121112,31.952162,35.233154
summer,2020,Tokyo,Japan,Panama,PAN,0,0,0,0,2,1,3,4326296,8.537981,-80.782127
summer,2020,Tokyo,Japan,Papua New Guinea,PNG,0,0,0,0,1,1,2,8975531,-6.314993,143.95555
summer,2020,Tokyo,Japan,Paraguay,PAR,0,0,0,0,1,1,2,7147553,-23.442503,-58.443832
summer,2020,Tokyo,Japan,United States of America ,CHN,96,60,51,207,120,136,256,#N/A,#N/A,#N/A
summer,2020,Tokyo,Japan,Peru,PER,1,0,0,1,7,4,11,33050211,-9.189967,-75.015152
summer,2020,Tokyo,Japan,Philippines,PHI,0,0,0,0,4,0,4,109830324,12.879721,121.774017
summer,2020,Tokyo,Japan,Poland,POL,7,6,12,25,55,36,91,37839255,51.919438,19.145136
summer,2020,Tokyo,Japan,Portugal,POR,0,0,2,2,24,10,34,10191409,39.399872,-8.224454
summer,2020,Tokyo,Japan,Puerto Rico,PUR,0,0,0,0,2,1,3,2846860,18.220833,-66.590149
summer,2020,Tokyo,Japan,Qatar,QAT,0,0,1,1,1,1,2,2889284,25.354826,51.183884
summer,2020,Tokyo,Japan,South Korea,KOR,2,10,12,24,57,28,85,51276977,35.907757,127.766922
summer,2020,Tokyo,Japan,Moldova,MDA,0,0,0,0,4,2,6,4032294,47.411631,28.369885
summer,2020,Tokyo,Japan,Romania,ROU,0,1,1,2,8,1,9,19214608,45.943161,24.96676
summer,2020,Tokyo,Japan,China,RPC,36,33,49,118,134,114,248,1440297825,35.86166,104.195397
summer,2020,Tokyo,Japan,Rwanda,RWA,0,0,0,0,1,13,14,13005303,-1.940278,29.873888
summer,2020,Tokyo,Japan,Sao Tome and Principe,STP,0,0,0,0,1,0,1,#N/A,#N/A,#N/A
summer,2020,Tokyo,Japan,Saudi Arabia,KSA,0,0,1,1,5,2,7,34905942,23.885942,45.079162
summer,2020,Tokyo,Japan,Senegal,SEN,0,0,0,0,2,1,3,16816539,14.497401,-14.452362
summer,2020,Tokyo,Japan,Serbia,SRB,2,3,1,6,13,7,20,8731081,44.016521,21.005859
summer,2020,Tokyo,Japan,Sierra Leone,SLE,0,0,0,0,1,1,2,8004158,8.460555,-11.779889
summer,2020,Tokyo,Japan,Singapore,SGP,2,0,0,2,5,6,11,5858322,1.352083,103.819836
summer,2020,Tokyo,Japan,Slovakia,SVK,5,2,4,11,21,7,28,5460109,48.669026,19.699024
summer,2020,Tokyo,Japan,Slovenia,SLO,0,1,1,2,7,0,7,2078989,46.151241,14.995463
summer,2020,Tokyo,Japan,Somalia,SOM,0,0,0,0,1,0,1,15965848,5.152149,46.199616
summer,2020,Tokyo,Japan,South Africa,RSA,4,1,2,7,20,14,34,59436725,-30.559482,22.937506
summer,2020,Tokyo,Japan,Spain,ESP,9,15,12,36,93,44,137,46757980,40.463667,-3.74922
summer,2020,Tokyo,Japan,Sri Lanka,SRI,1,0,1,2,8,1,9,21428970,7.873054,80.771797
summer,2020,Tokyo,Japan,St Vincent and the Grenadines,VIN,0,0,0,0,1,0,1,#N/A,#N/A,#N/A
summer,2020,Tokyo,Japan,Sweden,SWE,1,5,2,8,12,17,29,10110233,60.128161,18.643501
summer,2020,Tokyo,Japan,Switzerland,SUI,7,4,3,14,8,13,21,8665615,46.818188,8.227512
summer,2020,Tokyo,Japan,Syrian,SYR,0,0,0,0,1,2,3,17500658,34.8149,39.0465
summer,2020,Tokyo,Japan,Tajikistan,TJK,0,0,0,0,1,0,1,9573310,38.861034,71.276093
summer,2020,Tokyo,Japan,Thailand,THA,5,5,8,18,50,26,76,69830779,15.870032,100.992541
summer,2020,Tokyo,Japan,Togo,TOG,0,0,0,0,0,1,1,8310934,8.619543,0.824782
summer,2020,Tokyo,Japan,Tunisia,TUN,4,5,2,11,12,13,25,11839918,33.886917,9.537499
summer,2020,Tokyo,Japan,Turkey,TUR,2,4,9,15,43,44,87,84495243,38.963745,35.243322
summer,2020,Tokyo,Japan,Uganda,UGA,0,0,1,1,1,3,4,45974931,1.373333,32.290275
summer,2020,Tokyo,Japan,Ukraine,UKR,24,47,27,98,80,59,139,43686577,48.379433,31.16558
summer,2020,Tokyo,Japan,United Arab Emirates,UAE,1,1,1,3,7,5,12,9910892,23.424076,53.847818
summer,2020,Tokyo,Japan,United Republic of the Tanzania,TAN,0,0,0,0,1,1,2,#N/A,#N/A,#N/A
summer,2020,Tokyo,Japan,United States of America ,USA,37,36,31,104,120,123,243,#N/A,#N/A,#N/A
summer,2020,Tokyo,Japan,Uruguay,URU,0,0,0,0,1,1,2,3475842,-32.522779,-55.765835
summer,2020,Tokyo,Japan,Uzbekistan,UZB,8,5,6,19,25,19,44,33551824,41.377491,64.585262
summer,2020,Tokyo,Japan,Venezuela,VEN,3,2,2,7,13,14,27,28421581,6.42375,-66.58973
summer,2020,Tokyo,Japan,Vietnam,VIE,0,1,0,1,4,3,7,97490013,14.058324,108.277199
summer,2020,Tokyo,Japan,US Virgin Islands,ISV,0,0,0,0,0,1,1,104398,18.420695,-64.639968
summer,2020,Tokyo,Japan,Yemen,YEM,0,0,0,0,1,1,2,29935468,15.552727,48.516388
summer,2020,Tokyo,Japan,Zambia,ZAM,0,0,0,0,0,1,1,18468257,-13.133897,27.849332
summer,2020,Tokyo,Japan,Zimbabwe,ZIM,0,0,0,0,0,2,2,14899771,-19.015438,29.154857
winter,1976,Ornskoldsvik,Sweden,Austria,AUT,5,16,14,35,20,4,24,9015361,47.516231,14.550072
winter,1976,Ornskoldsvik,Sweden,Belgium,BEL,0,0,0,0,5,0,5,11598451,50.503887,4.469936
winter,1976,Ornskoldsvik,Sweden,Canada,CAN,2,0,2,4,5,1,6,37799407,56.130366,-106.346771
winter,1976,Ornskoldsvik,Sweden,Czechoslovakia,TCH,3,0,0,3,4,1,5,10732559,50.073658,14.41854
winter,1976,Ornskoldsvik,Sweden,Finland,FIN,8,7,7,22,22,4,26,5542237,61.92411,25.748151
winter,1976,Ornskoldsvik,Sweden,France,FRA,2,0,3,5,17,4,21,65298930,46.227638,2.213749
winter,1976,Ornskoldsvik,Sweden,Great Britain,GBR,0,0,0,0,6,0,6,67948282,55.378051,-3.435973
winter,1976,Ornskoldsvik,Sweden,Japan,JPN,0,0,0,0,1,0,1,126407422,36.204824,138.252924
winter,1976,Ornskoldsvik,Sweden,Norway,NOR,7,3,2,12,16,7,23,5428594,60.472024,8.468946
winter,1976,Ornskoldsvik,Sweden,Poland,POL,0,0,0,0,7,0,7,37839255,51.919438,19.145136
winter,1976,Ornskoldsvik,Sweden,Sweden,SWE,6,7,7,20,9,7,16,10110233,60.128161,18.643501
winter,1976,Ornskoldsvik,Sweden,Switzerland,SUI,10,1,1,12,11,4,15,8665615,46.818188,8.227512
winter,1976,Ornskoldsvik,Sweden,Uganda,UGA,0,0,0,0,1,0,1,45974931,1.373333,32.290275
winter,1976,Ornskoldsvik,Sweden,United States of America ,USA,0,0,0,0,1,0,1,#N/A,#N/A,#N/A
winter,1976,Ornskoldsvik,Sweden,Germany,FRG,10,12,6,28,27,5,32,83830972,51.165691,10.451526
winter,1976,Ornskoldsvik,Sweden,Yugoslavia,YUG,0,0,0,0,9,0,9,23528230,14.48329,121.02138
winter,1980,Geilo,Norway,Australia,AUS,0,0,0,0,2,0,2,25550683,-25.274398,133.775136
winter,1980,Geilo,Norway,Austria,AUT,6,10,6,22,27,7,34,9015361,47.516231,14.550072
winter,1980,Geilo,Norway,Canada,CAN,2,3,1,6,12,8,20,37799407,56.130366,-106.346771
winter,1980,Geilo,Norway,Czechoslovakia,TCH,0,1,0,1,2,1,3,10732559,50.073658,14.41854
winter,1980,Geilo,Norway,Denmark,DEN,0,0,0,0,6,2,8,5795780,56.26392,9.501785
winter,1980,Geilo,Norway,Finland,FIN,16,7,12,35,21,8,29,5542237,61.92411,25.748151
winter,1980,Geilo,Norway,France,FRA,1,1,1,3,19,2,21,65298930,46.227638,2.213749
winter,1980,Geilo,Norway,Great Britain,GBR,0,0,0,0,8,0,8,67948282,55.378051,-3.435973
winter,1980,Geilo,Norway,Italy,ITA,0,0,0,0,1,0,1,60446035,41.87194,12.56738
winter,1980,Geilo,Norway,Japan,JPN,0,0,0,0,5,0,5,126407422,36.204824,138.252924
winter,1980,Geilo,Norway,New Zealand,NZL,0,0,0,0,3,0,3,4829021,-40.900557,174.885971
winter,1980,Geilo,Norway,Norway,NOR,23,21,10,54,27,10,37,5428594,60.472024,8.468946
winter,1980,Geilo,Norway,Sweden,SWE,5,3,8,16,21,6,27,10110233,60.128161,18.643501
winter,1980,Geilo,Norway,Switzerland,SUI,4,2,4,10,20,7,27,8665615,46.818188,8.227512
winter,1980,Geilo,Norway,Uganda,UGA,0,0,0,0,1,0,1,45974931,1.373333,32.290275
winter,1980,Geilo,Norway,United States of America ,USA,4,1,1,6,16,10,26,#N/A,#N/A,#N/A
winter,1980,Geilo,Norway,Germany,FRG,3,6,9,18,29,9,38,83830972,51.165691,10.451526
winter,1980,Geilo,Norway,Yugoslavia,YUG,0,0,0,0,9,0,9,23528230,14.48329,121.02138
winter,1984,Innsbruck,Austria,Australia,AUS,0,0,0,0,3,0,3,25550683,-25.274398,133.775136
winter,1984,Innsbruck,Austria,Austria,AUT,34,19,17,70,42,17,59,9015361,47.516231,14.550072
winter,1984,Innsbruck,Austria,Belgium,BEL,0,0,0,0,3,0,3,11598451,50.503887,4.469936
winter,1984,Innsbruck,Austria,Canada,CAN,2,8,4,14,16,6,22,37799407,56.130366,-106.346771
winter,1984,Innsbruck,Austria,Czechoslovakia,TCH,0,0,0,0,1,1,2,10732559,50.073658,14.41854
winter,1984,Innsbruck,Austria,Denmark,DEN,0,0,0,0,3,2,5,5795780,56.26392,9.501785
winter,1984,Innsbruck,Austria,Finland,FIN,19,9,6,34,24,6,30,5542237,61.92411,25.748151
winter,1984,Innsbruck,Austria,France,FRA,4,2,0,6,14,2,16,65298930,46.227638,2.213749
winter,1984,Innsbruck,Austria,Great Britain,GBR,0,4,6,10,19,3,22,67948282,55.378051,-3.435973
winter,1984,Innsbruck,Austria,Italy,ITA,0,0,1,1,7,0,7,60446035,41.87194,12.56738
winter,1984,Innsbruck,Austria,Japan,JPN,0,0,0,0,13,2,15,126407422,36.204824,138.252924
winter,1984,Innsbruck,Austria,Netherlands,NED,0,0,0,0,5,1,6,17141544,52.132633,5.291266
winter,1984,Innsbruck,Austria,New Zealand,NZL,1,3,1,5,6,2,8,4829021,-40.900557,174.885971
winter,1984,Innsbruck,Austria,Norway,NOR,15,13,13,41,25,12,37,5428594,60.472024,8.468946
winter,1984,Innsbruck,Austria,Poland,POL,3,2,8,13,12,4,16,37839255,51.919438,19.145136
winter,1984,Innsbruck,Austria,Spain,ESP,0,0,0,0,4,0,4,46757980,40.463667,-3.74922
winter,1984,Innsbruck,Austria,Sweden,SWE,7,2,5,14,18,4,22,10110233,60.128161,18.643501
winter,1984,Innsbruck,Austria,Switzerland,SUI,5,16,16,37,42,8,50,8665615,46.818188,8.227512
winter,1984,Innsbruck,Austria,United States of America ,USA,7,14,14,35,33,18,51,#N/A,#N/A,#N/A
winter,1984,Innsbruck,Austria,Germany,FRG,10,14,10,34,25,6,31,83830972,51.165691,10.451526
winter,1984,Innsbruck,Austria,Yugoslavia,YUG,0,0,1,1,10,0,10,23528230,14.48329,121.02138
winter,1988,Innsbruck,Austria,Australia,AUS,0,0,0,0,5,0,5,25550683,-25.274398,133.775136
winter,1988,Innsbruck,Austria,Austria,AUT,20,10,14,44,37,15,52,9015361,47.516231,14.550072
winter,1988,Innsbruck,Austria,Belgium,BEL,0,0,0,0,2,0,2,11598451,50.503887,4.469936
winter,1988,Innsbruck,Austria,Canada,CAN,5,3,5,13,13,7,20,37799407,56.130366,-106.346771
winter,1988,Innsbruck,Austria,Czechoslovakia,TCH,0,0,0,0,3,1,4,10732559,50.073658,14.41854
winter,1988,Innsbruck,Austria,Denmark,DEN,0,0,0,0,3,0,3,5795780,56.26392,9.501785
winter,1988,Innsbruck,Austria,Finland,FIN,9,8,8,25,15,6,21,5542237,61.92411,25.748151
winter,1988,Innsbruck,Austria,France,FRA,5,5,3,13,15,1,16,65298930,46.227638,2.213749
winter,1988,Innsbruck,Austria,Great Britain,GBR,0,0,0,0,18,3,21,67948282,55.378051,-3.435973
winter,1988,Innsbruck,Austria,Italy,ITA,3,0,6,9,22,2,24,60446035,41.87194,12.56738
winter,1988,Innsbruck,Austria,Japan,JPN,0,0,2,2,11,2,13,126407422,36.204824,138.252924
winter,1988,Innsbruck,Austria,Netherlands,NED,0,0,0,0,6,2,8,17141544,52.132633,5.291266
winter,1988,Innsbruck,Austria,New Zealand,NZL,0,1,0,1,2,1,3,4829021,-40.900557,174.885971
winter,1988,Innsbruck,Austria,Norway,NOR,25,21,14,60,17,4,21,5428594,60.472024,8.468946
winter,1988,Innsbruck,Austria,Poland,POL,1,1,6,8,14,4,18,37839255,51.919438,19.145136
winter,1988,Innsbruck,Austria,Spain,ESP,1,2,1,4,6,1,7,46757980,40.463667,-3.74922
winter,1988,Innsbruck,Austria,Sweden,SWE,3,7,5,15,15,2,17,10110233,60.128161,18.643501
winter,1988,Innsbruck,Austria,Switzerland,SUI,8,7,8,23,28,4,32,8665615,46.818188,8.227512
winter,1988,Innsbruck,Austria,United States of America ,USA,7,17,6,30,31,14,45,#N/A,#N/A,#N/A
winter,1988,Innsbruck,Austria,USSR,URS,0,0,2,2,5,3,8,262436000,37.09024,-95.712891
winter,1988,Innsbruck,Austria,Germany,FRG,9,11,10,30,29,5,34,83830972,51.165691,10.451526
winter,1988,Innsbruck,Austria,Yugoslavia,YUG,0,0,0,0,3,0,3,23528230,14.48329,121.02138
winter,1992,"Albertville, Tignes",France,Australia,AUS,1,1,2,4,5,0,5,25550683,-25.274398,133.775136
winter,1992,"Albertville, Tignes",France,Austria,AUT,8,3,9,20,22,9,31,9015361,47.516231,14.550072
winter,1992,"Albertville, Tignes",France,Belgium,BEL,0,0,0,0,3,0,3,11598451,50.503887,4.469936
winter,1992,"Albertville, Tignes",France,Canada,CAN,2,4,6,12,14,5,19,37799407,56.130366,-106.346771
winter,1992,"Albertville, Tignes",France,Czechoslovakia,TCH,0,4,2,6,13,3,16,10732559,50.073658,14.41854
winter,1992,"Albertville, Tignes",France,Denmark,DEN,0,1,0,1,4,1,5,5795780,56.26392,9.501785
winter,1992,"Albertville, Tignes",France,Estonia,EST,0,0,0,0,0,1,1,1326693,58.595272,25.013607
winter,1992,"Albertville, Tignes",France,Finland,FIN,7,3,4,14,14,3,17,5542237,61.92411,25.748151
winter,1992,"Albertville, Tignes",France,France,FRA,6,4,9,19,28,3,31,65298930,46.227638,2.213749
winter,1992,"Albertville, Tignes",France,Germany,GER,12,17,9,38,30,6,36,83830972,51.165691,10.451526
winter,1992,"Albertville, Tignes",France,Great Britain,GBR,0,1,4,5,14,1,15,67948282,55.378051,-3.435973
winter,1992,"Albertville, Tignes",France,Italy,ITA,0,1,3,4,19,8,27,60446035,41.87194,12.56738
winter,1992,"Albertville, Tignes",France,Japan,JPN,0,0,2,2,11,4,15,126407422,36.204824,138.252924
winter,1992,"Albertville, Tignes",France,South Korea,KOR,0,0,0,0,2,0,2,51276977,35.907757,127.766922
winter,1992,"Albertville, Tignes",France,Liechtenstein,LIE,0,0,0,0,1,0,1,38147,47.166,9.555373
winter,1992,"Albertville, Tignes",France,Netherlands,NED,0,0,0,0,5,2,7,17141544,52.132633,5.291266
winter,1992,"Albertville, Tignes",France,New Zealand,NZL,2,0,0,2,7,0,7,4829021,-40.900557,174.885971
winter,1992,"Albertville, Tignes",France,Norway,NOR,5,5,4,14,19,4,23,5428594,60.472024,8.468946
winter,1992,"Albertville, Tignes",France,Poland,POL,2,0,3,5,11,2,13,37839255,51.919438,19.145136
winter,1992,"Albertville, Tignes",France,Spain,ESP,0,1,3,4,10,3,13,46757980,40.463667,-3.74922
winter,1992,"Albertville, Tignes",France,Sweden,SWE,1,1,2,4,5,4,9,10110233,60.128161,18.643501
winter,1992,"Albertville, Tignes",France,Switzerland,SUI,3,8,4,15,14,5,19,8665615,46.818188,8.227512
winter,1992,"Albertville, Tignes",France,Unified Team,EUN,10,8,3,21,16,5,21,#N/A,#N/A,#N/A
winter,1992,"Albertville, Tignes",France,United States of America ,USA,20,16,9,45,21,8,29,#N/A,#N/A,#N/A
winter,1994,Lillehammer,Norway,Australia,AUS,3,2,4,9,6,0,6,25550683,-25.274398,133.775136
winter,1994,Lillehammer,Norway,Austria,AUT,7,16,12,35,30,8,38,9015361,47.516231,14.550072
winter,1994,Lillehammer,Norway,Belarus,BLR,0,0,0,0,2,0,2,9448772,53.709807,27.953389
winter,1994,Lillehammer,Norway,Belgium,BEL,0,0,1,1,2,0,2,11598451,50.503887,4.469936
winter,1994,Lillehammer,Norway,Bulgaria,BUL,0,0,0,0,2,0,2,6939018,42.733883,25.48583
winter,1994,Lillehammer,Norway,Canada,CAN,1,2,5,8,25,6,31,37799407,56.130366,-106.346771
winter,1994,Lillehammer,Norway,Czech Republic,CZE,0,0,1,1,6,0,6,10712481,49.817492,15.472962
winter,1994,Lillehammer,Norway,Denmark,DEN,1,0,2,3,2,1,3,5795780,56.26392,9.501785
winter,1994,Lillehammer,Norway,Estonia,EST,0,0,1,1,11,2,13,1326693,58.595272,25.013607
winter,1994,Lillehammer,Norway,Finland,FIN,7,6,11,24,15,3,18,5542237,61.92411,25.748151
winter,1994,Lillehammer,Norway,France,FRA,14,6,11,31,23,3,26,65298930,46.227638,2.213749
winter,1994,Lillehammer,Norway,Germany,GER,25,21,18,64,33,10,43,83830972,51.165691,10.451526
winter,1994,Lillehammer,Norway,Great Britain,GBR,0,0,5,5,23,0,23,67948282,55.378051,-3.435973
winter,1994,Lillehammer,Norway,Iceland,ISL,0,0,0,0,1,0,1,341628,64.963051,-19.020835
winter,1994,Lillehammer,Norway,Italy,ITA,0,7,6,13,19,4,23,60446035,41.87194,12.56738
winter,1994,Lillehammer,Norway,Japan,JPN,0,3,3,6,19,7,26,126407422,36.204824,138.252924
winter,1994,Lillehammer,Norway,Kazakhstan,KAZ,0,1,0,1,1,1,2,18815231,48.019573,66.923684
winter,1994,Lillehammer,Norway,South Korea,KOR,0,0,0,0,2,0,2,51276977,35.907757,127.766922
winter,1994,Lillehammer,Norway,Latvia,LAT,0,0,0,0,1,0,1,1882408,56.879635,24.603189
winter,1994,Lillehammer,Norway,Liechtenstein,LIE,0,0,1,1,1,0,1,38147,47.166,9.555373
winter,1994,Lillehammer,Norway,Lithuania,LTU,0,0,0,0,1,1,2,2715340,55.169438,23.881275
winter,1994,Lillehammer,Norway,Netherlands,NED,1,0,3,4,5,1,6,17141544,52.132633,5.291266
winter,1994,Lillehammer,Norway,New Zealand,NZL,3,0,3,6,6,1,7,4829021,-40.900557,174.885971
winter,1994,Lillehammer,Norway,Norway,NOR,29,22,13,64,33,9,42,5428594,60.472024,8.468946
winter,1994,Lillehammer,Norway,Poland,POL,2,3,5,10,12,3,15,37839255,51.919438,19.145136
winter,1994,Lillehammer,Norway,Russia,RUS,10,12,8,30,19,8,27,145945524,61.52401,105.318756
winter,1994,Lillehammer,Norway,Slovakia,SVK,0,3,2,5,10,1,11,5460109,48.669026,19.699024
winter,1994,Lillehammer,Norway,Spain,ESP,1,6,3,10,10,4,14,46757980,40.463667,-3.74922
winter,1994,Lillehammer,Norway,Sweden,SWE,3,3,2,8,22,5,27,10110233,60.128161,18.643501
winter,1994,Lillehammer,Norway,Switzerland,SUI,2,9,5,16,15,4,19,8665615,46.818188,8.227512
winter,1994,Lillehammer,Norway,United States of America ,USA,24,12,7,43,22,8,30,#N/A,#N/A,#N/A
winter,1988,Nagano,Japan,Armenia,ARM,0,0,0,0,6,2,8,2964219,40.069099,45.038189
winter,1988,Nagano,Japan,Australia,AUS,1,0,1,2,4,0,4,25550683,-25.274398,133.775136
winter,1988,Nagano,Japan,Austria,AUT,7,16,11,34,25,9,34,9015361,47.516231,14.550072
winter,1988,Nagano,Japan,Belarus,BLR,0,0,0,0,3,2,5,9448772,53.709807,27.953389
winter,1988,Nagano,Japan,Bulgaria,BUL,0,0,0,0,3,0,3,6939018,42.733883,25.48583
winter,1988,Nagano,Japan,Canada,CAN,1,9,5,15,25,8,33,37799407,56.130366,-106.346771
winter,1988,Nagano,Japan,Czech Republic,CZE,3,3,1,7,3,3,6,10712481,49.817492,15.472962
winter,1988,Nagano,Japan,Denmark,DEN,1,0,1,2,2,1,3,5795780,56.26392,9.501785
winter,1988,Nagano,Japan,Estonia,EST,0,0,0,0,13,2,15,1326693,58.595272,25.013607
winter,1988,Nagano,Japan,Finland,FIN,7,5,7,19,14,7,21,5542237,61.92411,25.748151
winter,1988,Nagano,Japan,France,FRA,5,9,8,22,21,4,25,65298930,46.227638,2.213749
winter,1988,Nagano,Japan,Germany,GER,14,17,13,44,33,7,40,83830972,51.165691,10.451526
winter,1988,Nagano,Japan,Great Britain,GBR,0,0,0,0,20,1,21,67948282,55.378051,-3.435973
winter,1988,Nagano,Japan,Iran,IRI,0,0,0,0,2,0,2,84176929,32.427908,53.688046
winter,1988,Nagano,Japan,Italy,ITA,3,4,3,10,18,3,21,60446035,41.87194,12.56738
winter,1988,Nagano,Japan,Japan,JPN,12,16,13,41,53,14,67,126407422,36.204824,138.252924
winter,1988,Nagano,Japan,Kazakhstan,KAZ,0,0,0,0,1,0,1,18815231,48.019573,66.923684
winter,1988,Nagano,Japan,South Korea,KOR,0,0,0,0,3,1,4,51276977,35.907757,127.766922
winter,1988,Nagano,Japan,Netherlands,NED,0,1,1,2,2,1,3,17141544,52.132633,5.291266
winter,1988,Nagano,Japan,New Zealand,NZL,4,1,1,6,3,2,5,4829021,-40.900557,174.885971
winter,1988,Nagano,Japan,Norway,NOR,18,9,13,40,34,9,43,5428594,60.472024,8.468946
winter,1988,Nagano,Japan,Poland,POL,0,0,2,2,19,7,26,37839255,51.919438,19.145136
winter,1988,Nagano,Japan,Russia,RUS,12,10,9,31,25,10,35,145945524,61.52401,105.318756
winter,1988,Nagano,Japan,Slovakia,SVK,0,6,4,10,16,2,18,5460109,48.669026,19.699024
winter,1988,Nagano,Japan,Slovenia,SLO,0,0,0,0,1,0,1,2078989,46.151241,14.995463
winter,1988,Nagano,Japan,South Africa,RSA,0,0,0,0,1,0,1,59436725,-30.559482,22.937506
winter,1988,Nagano,Japan,Spain,ESP,8,0,0,8,10,4,14,46757980,40.463667,-3.74922
winter,1988,Nagano,Japan,Sweden,SWE,0,1,5,6,21,3,24,10110233,60.128161,18.643501
winter,1988,Nagano,Japan,Switzerland,SUI,10,5,8,23,15,4,19,8665615,46.818188,8.227512
winter,1988,Nagano,Japan,Ukraine,UKR,3,2,4,9,5,6,11,43686577,48.379433,31.16558
winter,1988,Nagano,Japan,United States of America ,USA,13,8,13,34,39,10,49,#N/A,#N/A,#N/A
winter,2002,Salt Lake City,United States of America ,Andorra,AND,0,0,0,0,2,0,2,77287,42.546245,1.601554
winter,2002,Salt Lake City,United States of America ,Armenia,ARM,0,0,0,0,4,2,6,2964219,40.069099,45.038189
winter,2002,Salt Lake City,United States of America ,Australia,AUS,6,1,0,7,6,0,6,25550683,-25.274398,133.775136
winter,2002,Salt Lake City,United States of America ,Austria,AUT,9,10,10,29,18,4,22,9015361,47.516231,14.550072
winter,2002,Salt Lake City,United States of America ,Belarus,BLR,1,1,0,2,3,1,4,9448772,53.709807,27.953389
winter,2002,Salt Lake City,United States of America ,Bulgaria,BUL,0,0,0,0,0,1,1,6939018,42.733883,25.48583
winter,2002,Salt Lake City,United States of America ,Canada,CAN,6,4,5,15,23,4,27,37799407,56.130366,-106.346771
winter,2002,Salt Lake City,United States of America ,Chile,CHI,0,0,0,0,2,0,2,19144605,-35.675147,-71.542969
winter,2002,Salt Lake City,United States of America ,United States of America ,CHN,0,0,0,0,3,1,4,#N/A,#N/A,#N/A
winter,2002,Salt Lake City,United States of America ,Croatia,CRO,0,0,0,0,1,1,2,4100719,45.1,15.2
winter,2002,Salt Lake City,United States of America ,Czech Republic,CZE,2,1,2,5,2,4,6,10712481,49.817492,15.472962
winter,2002,Salt Lake City,United States of America ,Denmark,DEN,0,0,0,0,0,1,1,5795780,56.26392,9.501785
winter,2002,Salt Lake City,United States of America ,Estonia,EST,0,0,0,0,13,0,13,1326693,58.595272,25.013607
winter,2002,Salt Lake City,United States of America ,Finland,FIN,4,1,3,8,8,6,14,5542237,61.92411,25.748151
winter,2002,Salt Lake City,United States of America ,France,FRA,2,11,6,19,12,6,18,65298930,46.227638,2.213749
winter,2002,Salt Lake City,United States of America ,Germany,GER,17,1,15,33,22,4,26,83830972,51.165691,10.451526
winter,2002,Salt Lake City,United States of America ,Great Britain,GBR,0,0,0,0,2,0,2,67948282,55.378051,-3.435973
winter,2002,Salt Lake City,United States of America ,Greece,GRE,0,0,0,0,1,0,1,10413936,39.074208,21.824312
winter,2002,Salt Lake City,United States of America ,Hungary,HUN,0,0,0,0,1,0,1,9655983,47.162494,19.503304
winter,2002,Salt Lake City,United States of America ,Iran,IRI,0,0,0,0,1,0,1,84176929,32.427908,53.688046
winter,2002,Salt Lake City,United States of America ,Italy,ITA,3,3,3,9,12,1,13,60446035,41.87194,12.56738
winter,2002,Salt Lake City,United States of America ,Japan,JPN,0,0,3,3,30,6,36,126407422,36.204824,138.252924
winter,2002,Salt Lake City,United States of America ,Kazakhstan,KAZ,0,0,0,0,1,0,1,18815231,48.019573,66.923684
winter,2002,Salt Lake City,United States of America ,South Korea,KOR,0,1,0,1,5,1,6,51276977,35.907757,127.766922
winter,2002,Salt Lake City,United States of America ,Netherlands,NED,1,3,0,4,3,1,4,17141544,52.132633,5.291266
winter,2002,Salt Lake City,United States of America ,New Zealand,NZL,4,0,2,6,1,1,2,4829021,-40.900557,174.885971
winter,2002,Salt Lake City,United States of America ,Norway,NOR,10,3,6,19,24,3,27,5428594,60.472024,8.468946
winter,2002,Salt Lake City,United States of America ,Poland,POL,1,0,2,3,9,5,14,37839255,51.919438,19.145136
winter,2002,Salt Lake City,United States of America ,Russia,RUS,7,9,5,21,19,7,26,145945524,61.52401,105.318756
winter,2002,Salt Lake City,United States of America ,Slovakia,SVK,0,3,6,9,12,2,14,5460109,48.669026,19.699024
winter,2002,Salt Lake City,United States of America ,South Africa,RSA,0,0,0,0,1,0,1,59436725,-30.559482,22.937506
winter,2002,Salt Lake City,United States of America ,Spain,ESP,3,2,2,7,6,2,8,46757980,40.463667,-3.74922
winter,2002,Salt Lake City,United States of America ,Sweden,SWE,0,6,3,9,17,2,19,10110233,60.128161,18.643501
winter,2002,Salt Lake City,United States of America ,Switzerland,SUI,6,4,2,12,16,2,18,8665615,46.818188,8.227512
winter,2002,Salt Lake City,United States of America ,Ukraine,UKR,0,6,6,12,7,3,10,43686577,48.379433,31.16558
winter,2002,Salt Lake City,United States of America ,United States of America ,USA,10,22,11,43,41,16,57,#N/A,#N/A,#N/A
winter,2006,Torino,Italy,Andorra,AND,0,0,0,0,1,1,2,77287,42.546245,1.601554
winter,2006,Torino,Italy,Armenia,ARM,0,0,0,0,1,1,2,2964219,40.069099,45.038189
winter,2006,Torino,Italy,Australia,AUS,0,1,1,2,9,1,10,25550683,-25.274398,133.775136
winter,2006,Torino,Italy,Austria,AUT,3,4,7,14,21,3,24,9015361,47.516231,14.550072
winter,2006,Torino,Italy,Belarus,BLR,1,6,2,9,3,3,6,9448772,53.709807,27.953389
winter,2006,Torino,Italy,Belgium,BEL,0,0,0,0,0,1,1,11598451,50.503887,4.469936
winter,2006,Torino,Italy,Bulgaria,BUL,0,0,0,0,2,1,3,6939018,42.733883,25.48583
winter,2006,Torino,Italy,Canada,CAN,5,3,5,13,27,7,34,37799407,56.130366,-106.346771
winter,2006,Torino,Italy,Chile,CHI,0,0,0,0,2,0,2,19144605,-35.675147,-71.542969
winter,2006,Torino,Italy,United States of America ,CHN,0,0,0,0,4,3,7,#N/A,#N/A,#N/A
winter,2006,Torino,Italy,Croatia,CRO,0,0,0,0,1,0,1,4100719,45.1,15.2
winter,2006,Torino,Italy,Czech Republic,CZE,0,1,0,1,4,1,5,10712481,49.817492,15.472962
winter,2006,Torino,Italy,Denmark,DEN,0,0,0,0,3,3,6,5795780,56.26392,9.501785
winter,2006,Torino,Italy,Finland,FIN,0,0,0,0,4,3,7,5542237,61.92411,25.748151
winter,2006,Torino,Italy,France,FRA,7,2,6,15,14,5,19,65298930,46.227638,2.213749
winter,2006,Torino,Italy,Germany,GER,8,5,5,18,29,5,34,83830972,51.165691,10.451526
winter,2006,Torino,Italy,Great Britain,GBR,0,1,0,1,18,2,20,67948282,55.378051,-3.435973
winter,2006,Torino,Italy,Hungary,HUN,0,0,0,0,1,1,2,9655983,47.162494,19.503304
winter,2006,Torino,Italy,Iran,IRI,0,0,0,0,1,0,1,84176929,32.427908,53.688046
winter,2006,Torino,Italy,Italy,ITA,2,2,4,8,33,6,39,60446035,41.87194,12.56738
winter,2006,Torino,Italy,Japan,JPN,2,5,2,9,33,7,40,126407422,36.204824,138.252924
winter,2006,Torino,Italy,Kazakhstan,KAZ,0,0,0,0,2,0,2,18815231,48.019573,66.923684
winter,2006,Torino,Italy,South Korea,KOR,0,0,0,0,3,0,3,51276977,35.907757,127.766922
winter,2006,Torino,Italy,Latvia,LAT,0,0,0,0,1,0,1,1882408,56.879635,24.603189
winter,2006,Torino,Italy,Mexico,MEX,0,0,0,0,1,0,1,129166028,23.634501,-102.552784
winter,2006,Torino,Italy,Mongolia,MGL,0,0,0,0,1,0,1,3287242,46.862496,103.846656
winter,2006,Torino,Italy,New Zealand,NZL,0,0,0,0,2,0,2,4829021,-40.900557,174.885971
winter,2006,Torino,Italy,Norway,NOR,1,1,3,5,25,3,28,5428594,60.472024,8.468946
winter,2006,Torino,Italy,Poland,POL,2,0,0,2,7,3,10,37839255,51.919438,19.145136
winter,2006,Torino,Italy,Russia,RUS,13,13,7,33,18,11,29,145945524,61.52401,105.318756
winter,2006,Torino,Italy,Slovakia,SVK,0,1,1,2,13,3,16,5460109,48.669026,19.699024
winter,2006,Torino,Italy,Slovenia,SLO,0,0,0,0,1,0,1,2078989,46.151241,14.995463
winter,2006,Torino,Italy,South Africa,RSA,0,0,0,0,1,0,1,59436725,-30.559482,22.937506
winter,2006,Torino,Italy,Spain,ESP,0,1,1,2,5,4,9,46757980,40.463667,-3.74922
winter,2006,Torino,Italy,Sweden,SWE,0,0,1,1,16,2,18,10110233,60.128161,18.643501
winter,2006,Torino,Italy,Switzerland,SUI,0,1,1,2,18,2,20,8665615,46.818188,8.227512
winter,2006,Torino,Italy,Ukraine,UKR,7,9,9,25,6,6,12,43686577,48.379433,31.16558
winter,2006,Torino,Italy,United States of America ,USA,7,2,3,12,44,11,55,#N/A,#N/A,#N/A
winter,2010,Vancouver,Canada,Andorra,AND,0,0,0,0,1,1,2,77287,42.546245,1.601554
winter,2010,Vancouver,Canada,Argentina,ARG,0,0,0,0,2,0,2,45267449,-38.416097,-63.616672
winter,2010,Vancouver,Canada,Armenia,ARM,0,0,0,0,1,1,2,2964219,40.069099,45.038189
winter,2010,Vancouver,Canada,Australia,AUS,0,1,3,4,9,2,11,25550683,-25.274398,133.775136
winter,2010,Vancouver,Canada,Austria,AUT,3,4,4,11,16,3,19,9015361,47.516231,14.550072
winter,2010,Vancouver,Canada,Belarus,BLR,2,0,7,9,6,3,9,9448772,53.709807,27.953389
winter,2010,Vancouver,Canada,Belgium,BEL,0,0,0,0,0,1,1,11598451,50.503887,4.469936
winter,2010,Vancouver,Canada,Bosnia and Herzegovina,BIH,0,0,0,0,1,0,1,3277152,43.915886,17.679076
winter,2010,Vancouver,Canada,Bulgaria,BUL,0,0,0,0,2,1,3,6939018,42.733883,25.48583
winter,2010,Vancouver,Canada,Canada,CAN,10,5,4,19,32,14,46,37799407,56.130366,-106.346771
winter,2010,Vancouver,Canada,Chile,CHI,0,0,0,0,2,0,2,19144605,-35.675147,-71.542969
winter,2010,Vancouver,Canada,United States of America ,CHN,0,0,0,0,5,2,7,#N/A,#N/A,#N/A
winter,2010,Vancouver,Canada,Croatia,CRO,0,0,0,0,3,1,4,4100719,45.1,15.2
winter,2010,Vancouver,Canada,Czech Republic,CZE,0,0,1,1,17,1,18,10712481,49.817492,15.472962
winter,2010,Vancouver,Canada,Denmark,DEN,0,0,0,0,0,2,2,5795780,56.26392,9.501785
winter,2010,Vancouver,Canada,Finland,FIN,0,1,1,2,3,2,5,5542237,61.92411,25.748151
winter,2010,Vancouver,Canada,France,FRA,1,4,1,6,17,4,21,65298930,46.227638,2.213749
winter,2010,Vancouver,Canada,Germany,GER,13,5,6,24,14,6,20,83830972,51.165691,10.451526
winter,2010,Vancouver,Canada,Great Britain,GBR,0,0,0,0,7,5,12,67948282,55.378051,-3.435973
winter,2010,Vancouver,Canada,Greece,GRE,0,0,0,0,1,1,2,10413936,39.074208,21.824312
winter,2010,Vancouver,Canada,Hungary,HUN,0,0,0,0,1,1,2,9655983,47.162494,19.503304
winter,2010,Vancouver,Canada,Iceland,ISL,0,0,0,0,0,1,1,341628,64.963051,-19.020835
winter,2010,Vancouver,Canada,Iran,IRI,0,0,0,0,1,0,1,84176929,32.427908,53.688046
winter,2010,Vancouver,Canada,Italy,ITA,1,3,3,7,29,6,35,60446035,41.87194,12.56738
winter,2010,Vancouver,Canada,Japan,JPN,3,3,5,11,33,8,41,126407422,36.204824,138.252924
winter,2010,Vancouver,Canada,Kazakhstan,KAZ,0,0,0,0,1,0,1,18815231,48.019573,66.923684
winter,2010,Vancouver,Canada,South Korea,KOR,0,1,0,1,23,2,25,51276977,35.907757,127.766922
winter,2010,Vancouver,Canada,Mexico,MEX,0,0,0,0,2,0,2,129166028,23.634501,-102.552784
winter,2010,Vancouver,Canada,Mongolia,MGL,0,0,0,0,2,0,2,3287242,46.862496,103.846656
winter,2010,Vancouver,Canada,Netherlands,NED,0,0,0,0,1,0,1,17141544,52.132633,5.291266
winter,2010,Vancouver,Canada,New Zealand,NZL,1,0,0,1,2,0,2,4829021,-40.900557,174.885971
winter,2010,Vancouver,Canada,Norway,NOR,1,3,2,6,24,3,27,5428594,60.472024,8.468946
winter,2010,Vancouver,Canada,Poland,POL,0,0,1,1,9,3,12,37839255,51.919438,19.145136
winter,2010,Vancouver,Canada,Romania,ROU,0,0,0,0,0,1,1,19214608,45.943161,24.96676
winter,2010,Vancouver,Canada,Russia,RUS,12,16,10,38,19,12,31,145945524,61.52401,105.318756
winter,2010,Vancouver,Canada,Serbia,SRB,0,0,0,0,1,0,1,8731081,44.016521,21.005859
winter,2010,Vancouver,Canada,Slovakia,SVK,6,2,3,11,10,3,13,5460109,48.669026,19.699024
winter,2010,Vancouver,Canada,Slovenia,SLO,0,0,0,0,1,0,1,2078989,46.151241,14.995463
winter,2010,Vancouver,Canada,South Africa,RSA,0,0,0,0,1,0,1,59436725,-30.559482,22.937506
winter,2010,Vancouver,Canada,Spain,ESP,1,2,0,3,3,2,5,46757980,40.463667,-3.74922
winter,2010,Vancouver,Canada,Sweden,SWE,0,0,2,2,22,3,25,10110233,60.128161,18.643501
winter,2010,Vancouver,Canada,Switzerland,SUI,1,2,0,3,10,5,15,8665615,46.818188,8.227512
winter,2010,Vancouver,Canada,Ukraine,UKR,5,8,6,19,11,8,19,43686577,48.379433,31.16558
winter,2010,Vancouver,Canada,United States of America ,USA,4,5,4,13,36,13,49,#N/A,#N/A,#N/A
winter,2014,Sochi,Russia,Andorra,AND,0,0,0,0,1,0,1,77287,42.546245,1.601554
winter,2014,Sochi,Russia,Argentina,ARG,0,0,0,0,3,0,3,45267449,-38.416097,-63.616672
winter,2014,Sochi,Russia,Armenia,ARM,0,0,0,0,1,0,1,2964219,40.069099,45.038189
winter,2014,Sochi,Russia,Australia,AUS,0,0,2,2,4,4,8,25550683,-25.274398,133.775136
winter,2014,Sochi,Russia,Austria,AUT,2,5,4,11,12,1,13,9015361,47.516231,14.550072
winter,2014,Sochi,Russia,Belarus,BLR,0,0,3,3,5,5,10,9448772,53.709807,27.953389
winter,2014,Sochi,Russia,Belgium,BEL,0,0,0,0,2,0,2,11598451,50.503887,4.469936
winter,2014,Sochi,Russia,Bosnia and Herzegovina,BIH,0,0,0,0,1,1,2,3277152,43.915886,17.679076
winter,2014,Sochi,Russia,Brazil,BRA,0,0,0,0,2,0,2,212821986,-14.235004,-51.92528
winter,2014,Sochi,Russia,Bulgaria,BUL,0,0,0,0,2,0,2,6939018,42.733883,25.48583
winter,2014,Sochi,Russia,Canada,CAN,7,2,7,16,37,12,49,37799407,56.130366,-106.346771
winter,2014,Sochi,Russia,Chile,CHI,0,0,0,0,2,0,2,19144605,-35.675147,-71.542969
winter,2014,Sochi,Russia,United States of America ,CHN,0,0,0,0,9,1,10,#N/A,#N/A,#N/A
winter,2014,Sochi,Russia,Croatia,CRO,0,0,0,0,2,0,2,4100719,45.1,15.2
winter,2014,Sochi,Russia,Czech Republic,CZE,0,0,0,0,18,0,18,10712481,49.817492,15.472962
winter,2014,Sochi,Russia,Denmark,DEN,0,0,0,0,1,1,2,5795780,56.26392,9.501785
winter,2014,Sochi,Russia,Finland,FIN,0,1,0,1,8,5,13,5542237,61.92411,25.748151
winter,2014,Sochi,Russia,France,FRA,5,3,4,12,11,3,14,65298930,46.227638,2.213749
winter,2014,Sochi,Russia,Germany,GER,9,5,1,15,7,6,13,83830972,51.165691,10.451526
winter,2014,Sochi,Russia,Great Britain,GBR,1,3,2,6,6,6,12,67948282,55.378051,-3.435973
winter,2014,Sochi,Russia,Greece,GRE,0,0,0,0,1,0,1,10413936,39.074208,21.824312
winter,2014,Sochi,Russia,Iceland,ISL,0,0,0,0,1,1,2,341628,64.963051,-19.020835
winter,2014,Sochi,Russia,Iran,IRI,0,0,0,0,1,0,1,84176929,32.427908,53.688046
winter,2014,Sochi,Russia,Italy,ITA,0,0,0,0,29,4,33,60446035,41.87194,12.56738
winter,2014,Sochi,Russia,Japan,JPN,3,1,2,6,14,6,20,126407422,36.204824,138.252924
winter,2014,Sochi,Russia,Kazakhstan,KAZ,0,0,0,0,3,2,5,18815231,48.019573,66.923684
winter,2014,Sochi,Russia,South Korea,KOR,0,0,0,0,23,4,27,51276977,35.907757,127.766922
winter,2014,Sochi,Russia,Mexico,MEX,0,0,0,0,1,0,1,129166028,23.634501,-102.552784
winter,2014,Sochi,Russia,Mongolia,MGL,0,0,0,0,1,0,1,3287242,46.862496,103.846656
winter,2014,Sochi,Russia,Netherlands,NED,1,0,0,1,4,3,7,17141544,52.132633,5.291266
winter,2014,Sochi,Russia,Neutral Para Athlete,NPA,0,0,0,0,0,1,1,#N/A,#N/A,#N/A
winter,2014,Sochi,Russia,New Zealand,NZL,0,1,0,1,3,0,3,4829021,-40.900557,174.885971
winter,2014,Sochi,Russia,Norway,NOR,1,2,1,4,24,6,30,5428594,60.472024,8.468946
winter,2014,Sochi,Russia,Poland,POL,0,0,0,0,7,0,7,37839255,51.919438,19.145136
winter,2014,Sochi,Russia,Romania,ROU,0,0,0,0,0,1,1,19214608,45.943161,24.96676
winter,2014,Sochi,Russia,Russia,RUS,30,28,22,80,51,17,68,145945524,61.52401,105.318756
winter,2014,Sochi,Russia,Serbia,SRB,0,0,0,0,1,0,1,8731081,44.016521,21.005859
winter,2014,Sochi,Russia,Slovakia,SVK,3,2,2,7,11,4,15,5460109,48.669026,19.699024
winter,2014,Sochi,Russia,Slovenia,SLO,0,0,0,0,1,0,1,2078989,46.151241,14.995463
winter,2014,Sochi,Russia,Spain,ESP,1,1,1,3,5,2,7,46757980,40.463667,-3.74922
winter,2014,Sochi,Russia,Sweden,SWE,1,2,1,4,18,4,22,10110233,60.128161,18.643501
winter,2014,Sochi,Russia,Switzerland,SUI,1,0,0,1,8,0,8,8665615,46.818188,8.227512
winter,2014,Sochi,Russia,Turkey,TUR,0,0,0,0,2,0,2,84495243,38.963745,35.243322
winter,2014,Sochi,Russia,Ukraine,UKR,5,9,11,25,14,9,23,43686577,48.379433,31.16558
winter,2014,Sochi,Russia,United States of America ,USA,2,7,9,18,52,20,72,#N/A,#N/A,#N/A
winter,2014,Sochi,Russia,Uzbekistan,UZB,0,0,0,0,2,0,2,33551824,41.377491,64.585262
winter,2018,Pyeongchang,South Korea,Andorra,AND,0,0,0,0,1,0,1,77287,42.546245,1.601554
winter,2018,Pyeongchang,South Korea,Argentina,ARG,0,0,0,0,2,0,2,45267449,-38.416097,-63.616672
winter,2018,Pyeongchang,South Korea,Armenia,ARM,0,0,0,0,1,0,1,2964219,40.069099,45.038189
winter,2018,Pyeongchang,South Korea,Australia,AUS,1,0,3,4,9,2,11,25550683,-25.274398,133.775136
winter,2018,Pyeongchang,South Korea,Austria,AUT,0,2,5,7,10,3,13,9015361,47.516231,14.550072
winter,2018,Pyeongchang,South Korea,Belarus,BLR,4,4,4,12,7,7,14,9448772,53.709807,27.953389
winter,2018,Pyeongchang,South Korea,Belgium,BEL,0,0,1,1,1,1,2,11598451,50.503887,4.469936
winter,2018,Pyeongchang,South Korea,Bosnia and Herzegovina,BIH,0,0,0,0,0,1,1,3277152,43.915886,17.679076
winter,2018,Pyeongchang,South Korea,Brazil,BRA,0,0,0,0,2,1,3,212821986,-14.235004,-51.92528
winter,2018,Pyeongchang,South Korea,Bulgaria,BUL,0,0,0,0,1,0,1,6939018,42.733883,25.48583
winter,2018,Pyeongchang,South Korea,Canada,CAN,8,4,16,28,39,13,52,37799407,56.130366,-106.346771
winter,2018,Pyeongchang,South Korea,Chile,CHI,0,0,0,0,4,0,4,19144605,-35.675147,-71.542969
winter,2018,Pyeongchang,South Korea,United States of America ,CHN,1,0,0,1,20,6,26,#N/A,#N/A,#N/A
winter,2018,Pyeongchang,South Korea,Croatia,CRO,1,0,1,2,6,1,7,4100719,45.1,15.2
winter,2018,Pyeongchang,South Korea,Czech Republic,CZE,0,0,0,0,20,1,21,10712481,49.817492,15.472962
winter,2018,Pyeongchang,South Korea,Denmark,DEN,0,0,0,0,1,0,1,5795780,56.26392,9.501785
winter,2018,Pyeongchang,South Korea,Finland,FIN,1,0,2,3,10,3,13,5542237,61.92411,25.748151
winter,2018,Pyeongchang,South Korea,France,FRA,7,8,5,20,9,2,11,65298930,46.227638,2.213749
winter,2018,Pyeongchang,South Korea,Georgia,GEO,0,0,0,0,1,1,2,3987805,42.315407,43.356892
winter,2018,Pyeongchang,South Korea,Germany,GER,7,8,4,19,9,11,20,83830972,51.165691,10.451526
winter,2018,Pyeongchang,South Korea,Great Britain,GBR,1,4,2,7,9,5,14,67948282,55.378051,-3.435973
winter,2018,Pyeongchang,South Korea,Greece,GRE,0,0,0,0,1,0,1,10413936,39.074208,21.824312
winter,2018,Pyeongchang,South Korea,Hungary,HUN,0,0,0,0,1,1,2,9655983,47.162494,19.503304
winter,2018,Pyeongchang,South Korea,Iceland,ISL,0,0,0,0,1,0,1,341628,64.963051,-19.020835
winter,2018,Pyeongchang,South Korea,Iran,IRI,0,0,0,0,3,2,5,84176929,32.427908,53.688046
winter,2018,Pyeongchang,South Korea,Italy,ITA,2,2,1,5,25,0,25,60446035,41.87194,12.56738
winter,2018,Pyeongchang,South Korea,Japan,JPN,3,4,3,10,33,5,38,126407422,36.204824,138.252924
winter,2018,Pyeongchang,South Korea,Kazakhstan,KAZ,1,0,0,1,5,1,6,18815231,48.019573,66.923684
winter,2018,Pyeongchang,South Korea,South Korea,KOR,1,0,2,3,32,4,36,51276977,35.907757,127.766922
winter,2018,Pyeongchang,South Korea,North Korea,PRK,0,0,0,0,2,0,2,25798588,40.339852,127.510093
winter,2018,Pyeongchang,South Korea,Mexico,MEX,0,0,0,0,1,0,1,129166028,23.634501,-102.552784
winter,2018,Pyeongchang,South Korea,Mongolia,MGL,0,0,0,0,1,0,1,3287242,46.862496,103.846656
winter,2018,Pyeongchang,South Korea,Netherlands,NED,3,3,1,7,4,5,9,17141544,52.132633,5.291266
winter,2018,Pyeongchang,South Korea,Neutral Para Athlete,NPA,0,0,0,0,13,17,30,#N/A,#N/A,#N/A
winter,2018,Pyeongchang,South Korea,New Zealand,NZL,1,0,2,3,3,0,3,4829021,-40.900557,174.885971
winter,2018,Pyeongchang,South Korea,Norway,NOR,1,3,4,8,26,5,31,5428594,60.472024,8.468946
winter,2018,Pyeongchang,South Korea,Poland,POL,0,0,1,1,6,1,7,37839255,51.919438,19.145136
winter,2018,Pyeongchang,South Korea,Romania,ROU,0,0,0,0,1,0,1,19214608,45.943161,24.96676
winter,2018,Pyeongchang,South Korea,Serbia,SRB,0,0,0,0,1,0,1,8731081,44.016521,21.005859
winter,2018,Pyeongchang,South Korea,Slovakia,SVK,6,4,1,11,8,3,11,5460109,48.669026,19.699024
winter,2018,Pyeongchang,South Korea,Slovenia,SLO,0,0,0,0,1,0,1,2078989,46.151241,14.995463
winter,2018,Pyeongchang,South Korea,Spain,ESP,0,1,1,2,2,1,3,46757980,40.463667,-3.74922
winter,2018,Pyeongchang,South Korea,Sweden,SWE,0,1,0,1,22,2,24,10110233,60.128161,18.643501
winter,2018,Pyeongchang,South Korea,Switzerland,SUI,3,0,0,3,10,3,13,8665615,46.818188,8.227512
winter,2018,Pyeongchang,South Korea,Tajikistan,TJK,0,0,0,0,1,0,1,9573310,38.861034,71.276093
winter,2018,Pyeongchang,South Korea,Turkey,TUR,0,0,0,0,1,0,1,84495243,38.963745,35.243322
winter,2018,Pyeongchang,South Korea,Ukraine,UKR,7,7,8,22,14,6,20,43686577,48.379433,31.16558
winter,2018,Pyeongchang,South Korea,United States of America ,USA,13,15,8,36,50,18,68,#N/A,#N/A,#N/A
winter,2018,Pyeongchang,South Korea,Uzbekistan,UZB,0,0,0,0,0,1,1,33551824,41.377491,64.585262